áarinnar 	 árinnar
acuparia 	 aucuparia
aðalbláæðir 	 aðalbláæðar
aðalega 	 aðallega
aðalega 	 aðallega
aðalega 	 aðallega
aðalega 	 aðallega
aðalega 	 aðallega
aðalega 	 aðallega
aðalega 	 aðallega
aðalega 	 aðallega
aðalega 	 aðallega
aðalega 	 aðallega
aðalega 	 aðallega
aðalega 	 aðallega
aðalherbergi 	 baðherbergi
aðalkirkunnar 	 aðalkirkjunnar
aðalkvennhlutverkið 	 aðalkvennhlutverkinu
aðalsgestasofa 	 aðalsgestastofa
aðalsgestasofa 	 aðalsgestastofa
aðalsöngvarinn 	 aðalsöngvari
aðalspraut 	 aðalsprauta
aðdáendi 	 aðdáandi
aððallega 	 aðallega
ádeilanleg 	 umdeilanleg
adenósínþrífosfat 	 gúanósínþrífosfat
aðflutur 	 aðfluttur
aðgægjast 	 gægjast
aðgerðarsinna 	 aðgerðasinna
aðgerðarsinninn 	 aðgerðasinninn
aðgreinanlegasta 	 auðgreinanlegasta
aðhláturefnið 	 aðhlátursefnið
aðhyltist 	 aðhylltist
aðilan 	 aðilann
aðilaríki 	 aðildarríki
aðildaríki 	 aðildarríki
aðiliar 	 aðilar
aðkomustaður 	 viðkomustaður
aðlagsta 	 aðlagast
aðlalsalurinn 	 aðalsalurinn
aðlasöguhetjuna 	 aðalsöguhetjuna
aðskilar 	 aðskildar
aðskilnaðarstefnunar 	 aðskilnaðarstefnunnar
aðskilnaðarstefnunar 	 aðskilnaðarstefnunnar
aðskilnum 	 aðskildum
aðstæðu 	 aðstæðum
aðstoðarskólastýra 	 aðstoðarskólastjóri
aðstoðu 	 aðstöðu
aðtæður 	 aðstæður
adygesku 	 adygeysku
æðakóngs 	 æðarkóngs
æfilangt 	 ævilangt
ægisvald 	 ægivald
áeldri 	 eldri
æskuærin 	 æskuárin
ættföðursins 	 ættföðurins
ættgöfga 	 ættgöfgi
ættgöfga 	 ættgöfgi
ætthvísl 	 ættkvísl
ættkvís 	 ættkvísl
ævintýraheimaum 	 ævintýraheimum
’afandī 	 afandī
afbrigiðið 	 afbrigðið
afbrygðissöm 	 afbrigðissöm
afdrigðin 	 afbrigðin
áfengismeðferða 	 áfengismeðferð
afhvæmi 	 afkvæmi
afkóðar 	 afkóðari
afkóðar 	 afkóðari
afkóðari 	 afkóðar
aflfæði 	 aflfræði
áflogslínuna 	 áflogalínuna
afriskri 	 afrískri
afró-asísku 	 afróasísku
afskektasti 	 afskekktasti
afstöuð 	 afstöðu
aftýrt 	 afstýrt
afþreyingi 	 afþreying
agangeislun 	 agnageislun
agnageislun 	 agnageisla
áheyrslu 	 áherslu
áhresla 	 áhersla
áhugagrasafræðings 	 áhugagrasafræðingi
áhugmál 	 áhugamál
aímaríska 	 aímarískt
akit 	 kit
akreinir 	 akreinar
aktiníðar 	 aktiníð
aktívismi 	 aktífismi
ákvarðatöku 	 ákvarðanatöku
ákveðn 	 ákveðin
álaggirnar 	 laggirnar
aldinbori 	 aldinborri
alemanníska 	 alemannísku
aleutíska 	 aleútíska
aleutíska 	 aleútíska
álfræðilega 	 sálfræðilega
álfræðilega 	 sálfræðilega
algegnt 	 algengt
algegnust 	 algengust
algenasta 	 algengasta
algengastu 	 algengasta
algengastu 	 algengasta
algent 	 algengt
alkahólistar 	 alkóhólistar
alkohól 	 alkóhól
allann 	 allan
allhvít 	 alhvít
allmennt 	 almennt
allþjóða 	 alþjóða
almannafjárs 	 almannafjár
álmategundin 	 álmtegundin
almeningur 	 almenningur
almenningsamgöngum 	 almenningssamgöngutækjum
alment 	 almennt
alment 	 almennt
almmennt 	 almennt
almnningi 	 almenningi
alræmdasta 	 alræmdastu
alríkishéraði 	 alríkishéraðið
alríkishéraðsins 	 alríkishéraði
alríkishéraðsins 	 alríkishéraðið
alsbert 	 allsbert
alsherjarskortur 	 allsherjarskortur
alvarlegart 	 alvarlegar
alþjóða¬mál 	 alþjóðamál
alþjóðasamskipti 	 alþjóðasamskiptum
alþjóðasamskiptum 	 alþjóðasamskipti
alþjólegum 	 alþjóðlegum
amfíbólflokknum 	 amfibólflokknum
amphibiaer 	 amphibia
amtmnann 	 amtmann
and-grugg 	 andgrugg
and 	 land
andspyrnuhreifingin 	 andspyrnuhreyfingin
andúð 	 íandúð
áningastaður 	 áningarstaður
anjsósuna 	 ansjósuna
ankaramíti 	 ankaramíts
annann 	 annan
annarar 	 annarrar
annarar 	 annarrar
annarar 	 annarrar
annararri 	 annarri
annari 	 annarri
annari 	 annarri
annari 	 annarri
annari 	 annarri
annari 	 annarri
annrs 	 annars
ansjónan 	 ansjósan
anstæðunni 	 andstæðunni
anstæðunni 	 andstæðunni
appelsínusafanum 	 appelsínusafan
appelsíusafa 	 appelsínusafa
‘apud 	 apud
áræðanlegar 	 áreiðanlegar
áratug 	 áratugs
áratug 	 áratugs
áratug 	 áratugs
áratugs 	 áratug
áratugsins 	 áratugarins
aravakíska 	 aravakískt
áreyrym 	 áreyrum
arfbundin 	 arfbundinn
argentínksi 	 argentínski
arkítekta 	 arkitekta
arkítektum 	 arkitektum
arkitektúrina 	 arkitektúrinn
armönsk 	 armensk
armönskum 	 armenskum
árósina 	 árósana
ársárskrift 	 ársáskrift
árstíðarskipt 	 árstíðaskipt
árstímum 	 árstíðum
artifiose 	 artificiose
árunm 	 árunum
ása« 	 ása
aserbaídsjíska 	 aserbaídsjanska
ásiáttur 	 ásláttur
asperíni 	 aspiríni
ástæðun 	 ástæðuna
ástæðun 	 ástæðuna
ástró-asískra 	 ástróasískra
ástró-asísku 	 ástróasísku
ástrónesíst 	 ástrónesískt
átækt 	 átæk
átækt 	 átæk
atburðarásir 	 atburðarás
athugandann 	 athuganda
atlandshafslaxar 	 atlantshafslaxar
atomizer 	 cartomizer
áttflötungar 	 áttflötunga
áttflötungar 	 áttflötunga
áttján 	 átján
auðigur 	 auðugur
auglýsinga-iðnaðinum 	 auglýsingaiðnaðinum
aukaafurði 	 aukaafurð
aukaafurði 	 aukaafurð
aukafollunum 	 aukaföllunum
aukahlutverk 	 aukahlutverki
austjóskir 	 austurjóskir
austjóskir 	 austurjóskir
austugermönsk 	 austurgermönsk
austurasísk 	 austur-asísk
austurátt 	 suðausturátt
austurátt 	 suðausturátt
austurgermönsk 	 vesturgermönsk
austurkarabískur 	 austkarabískur
austur-karabískur 	 austurkarabískur
austurskagans 	 suðausturskagans
austurskagans 	 suðausturskagans
austur-strönd 	 austurströnd
austur-vígstöðvarnar 	 austurvígstöðvarnar
áþreyfanlega 	 áþreifanlega
bæðin 	 bæði
bæðin 	 bæði
bæjastæðunum 	 bæjarstæðunum
bæjir 	 bæir
bækur 	 bækr
bæta 	 íbæta
bæum 	 bæjum
bæum 	 bæjum
baju-refillinn 	 bæjö-refillinn
bakeríi 	 bakaríi
bakeríi 	 bakaríi
bakkalárhráðu 	 bakkalárgráðu
bakkalárshgráðu 	 bakkalársgráðu
bakteríur 	 blábakteríur
bandaríkjaforseta 	 bandaríkjaforseti
bandaríks 	 bandarísk
bandtrik 	 bandstrik
bandvefsjúpur 	 bandvefshjúpur
bankanaskattaskjól 	 bankannaskattaskjól
bannvænt 	 banvænt
bannvænt 	 banvænt
bantúmálinu 	 bantúmálsins
barrskógaog 	 barrskóga
barrté 	 barrtré
basneska 	 baskneska
bass 	 bassi
bassie 	 bassi
belnam’ 	 belnam
beyttur 	 beittur
bifhlól 	 bifhjól
bigalowii 	 bigelowii
bílakjallaranum 	 bílakjallara
bílakjallaranum 	 bílakjallara
binst 	 bindst
bíómmyndum 	 bíómyndum
bipustalatus 	 bipustulatus
biskupsstolnum 	 biskupsstólnum
björgunarsveitarinn 	 björgunarsveitarinnar
bjórtegund 	 bjórategund
bláann 	 bláan
bláann 	 bláan
blábakteríur 	 bakteríur
blaðlýsog 	 blaðlýs
blaðstilkars 	 blaðstilkar
blá-græna 	 blágræna
bláleitann 	 bláleitan
bleading 	 bleeding
bleksíláti 	 blekíláti
blóðrásakerfi 	 blóðrásarkerfi
↑blóðþrýstingur→ 	 ↓blóðþrýstingur→
↓blóðþrýstingur→ 	 ↑blóðþrýstingur→
blokinni 	 blokkinni
blokinni 	 blokkinni
blokkinni 	 blokinni
blokkinni 	 blokinni
blómasafi 	 blómasafa
blóþrýstingsfall 	 blóðþrýstingsfall
boginar 	 bognar
böglaberum 	 bögglaberum
böglaberum 	 bögglaberum
bókasögn 	 bókasöfn
bókasögn 	 bókasöfn
bóndabæjana 	 bóndabæjanna
boraverksmiðju 	 borverksmiðju
borðnir 	 bornir
borgaravitundinni 	 borgaravitund
borgarmökin 	 borgarmörkin
borgarvikri 	 borgarvirki
borgini 	 borginni
boroðað 	 borðað
botnin 	 botninn
botnin 	 botninn
botnvörpumsem 	 botnvörpum
bráðklárir 	 bráðklárar
bræðingshlómveit 	 bræðingshlómsveit
brasilíksa 	 brasilíska
brátskráða 	 brautskráða
brauðvaradeildum 	 brauðdeildum
brautarhermun 	 brautarhermunar
breiðskifa 	 breiðskífa
breiskleika 	 breyskleika
breitileika 	 breytileika
breitingar 	 breytingar
breiting 	 breyting
breiting 	 breyting
breiting 	 breyting
breitir 	 breytir
brennsistein 	 brennisteini
brenntu 	 brenndu
breyddar 	 breiddar
brinjuna 	 brynjuna
brjóstast 	 brjótast
brjóstfiska 	 brjóskfiska
brjósviði 	 brjóstsviði
brtti 	 bretti
brtti 	 bretti
brúðguman 	 brúðgumann
brúðkauðinu 	 brúðkaupinu
brýþonska 	 brýþonsku
brýþonska 	 brýþonsku
‘bu’ 	 ‘bun’
búddhahof 	 búddahof
búddhatrúarmanna 	 búddatrúarmanna
‘bun’ 	 ‘bu’
burreimingu 	 þurreimingu
bygð 	 byggð
bygð 	 byggð
byggdarlagi 	 byggðarlagi
bygginameistara 	 byggingameistara
byggingaaðferðum 	 byggingaaðferða
byggingaaðferðum 	 byggingaaðferða
byggingareining 	 aðalbyggingareining
byggingarverkfræðinga 	 byggingaverkfræðinga
bylinguna 	 byltinguna
bylltingakennd 	 byltingakennd
byrjarði 	 byrjaði
byrjunni 	 byrjun
byrkningar 	 byrkninga
byrtist 	 birtist
byrtist 	 birtist
cartomizer 	 atomizer
cartomizer 	 clearomizer
clearomizer 	 cartomizer
comic 	 comics
comics 	 comic
corderoíti 	 korderoíti
coronaveirur 	 picornaveirur
crab 	 crabe
dalbotnins 	 dalbotns
dalssins 	 dalsins
dansstíls 	 dansstíll
debitkort 	 debetkort
decibel 	 desibel
degið 	 dregið
deildarinna 	 deildarinnar
deildarjöfnum 	 deildajöfnum
deilitengund 	 deilitegundir
demokrata 	 demókrata
demokrata 	 demókrata
demokratar 	 demókratar
demokratar 	 demókratar
demokrötum 	 demókrötum
demokrötum 	 demókrötum
desmeber 	 desember
desmeber 	 desember
deyji 	 deyi
deyji 	 deyi
deyji 	 deyi
deyji 	 deyi
deyji 	 deyi
deyji 	 deyi
digitadöbb 	 digidöbb
dingoar 	 dingóar
díselolíu 	 dísilolíu
djasse 	 djass
djass-rokk 	 djassrokk
djasssöng 	 jasssöng
djöfullin 	 djöfullinn
dögginn 	 döggin
dögu 	 dögum
dökkbláann 	 dökkbláan
dökkrrauðir 	 dökkrauðr
dom 	 doom
dómkirkjaí 	 dómkirkja
dómstol 	 dómstól
doom 	 dom
dótturinn 	 dótturina
drefiðist 	 dreifðist
drenna 	 renna
dreyfða 	 dreifða
dreyfða 	 dreifða
dreyfingu 	 dreifingu
dreyfir 	 dreifir
dreyfir 	 dreifir
dreyfist 	 dreifist
dreyfst 	 dreifst
drógst 	 dróst
drógst 	 dróst
drottingar 	 drottningar
drottninginni 	 drottningunni
drottnunarreiknirit 	 drottnunarreikniritum
drottnunarreikniritum 	 drottnunarreiknirit
drullugan 	 drullugann
drungarokkshljómsveit 	 svartþungarokkshljómsveit
drungarokkshljómsveit 	 þungarokkshljómsveit
dufari 	 daufari
dúfnabaun 	 dúfnabaunir
dundurspillir 	 tundurspillir
dúnfjáðrir 	 dúnfjaðrir
dúnfjáðrir 	 dúnfjaðrir
dúnni 	 dúni
duttlungafylltri 	 duttlungafyllri
dykkjarker 	 drykkjarker
dýraverndarástæðum 	 dýraverndunarástæðum
dýrsfrumum 	 dýrafrumum
dýrsfrumur 	 dýrsfrumum
ecaudatuser 	 ecaudatus
eðileg 	 eðlileg
eðlisfræðingur 	 heimsfræðingur
eðlisfræðingur 	 heimsfræðingur
eðlisfræðiverkefni 	 rafgaseðlisfræðiverkefni
edru 	 eru
edru 	 eru
effecta 	 effekta
effectum 	 effektum
efmafæðilega 	 efnafæðilega
efnastjórnunaraðferðir 	 efnastjórnunaraðferðirnar
efnhagslegs 	 efnahagslegs
efnishyggjunar 	 efnishyggjunnar
efnsambönd 	 efnasambönd
efti 	 eftir
eftir 	 efti
eftirtektaverðast 	 eftirtektarverðust
eftri 	 efri
eggfóstursfæðing 	 gulfóstursfæðing
eggfóstursfæðing 	 gulfóstursfæðing
eiðilagðist 	 eyðilagðist
eigingleg 	 eigigleg
eiginleikia 	 eiginleika
eignuðust 	 eignuðist
eijarnir 	 eyjarnir
einandrandi 	 einangrandi
einandrunargildi 	 einangrunargildi
einangrunnar 	 einangrunar
einfadlega 	 einfaldlega
einfaldega 	 einfaldlega
einföldunnar 	 einföldunar
eingar 	 engar
eingin 	 engin
eingin 	 engin
eingin 	 engin
eingnað 	 eignað
eingnað 	 eignað
einhlýtt 	 einhlítt
einhveru 	 einhverju
einier 	 einer
einig 	 einnig
einig 	 einnig
einig 	 einnig
einig 	 einnig
einkaeign 	 einkaeigu
einkendis 	 einkenndist
einkenninst 	 einkennist
einkenntist 	 einkenndist
einmannalegasta 	 einmanalegasta
einning 	 einnig
einning 	 einnig
einning 	 einnig
einning 	 einnig
einning 	 einnig
einning 	 einnig
einning 	 kenning
einnkaþjónn 	 einkaþjónn
einsleitnar 	 einsleitar
einsleitnari 	 einsleitari
einstaklingir 	 einstaklingar
einsx 	 eins
einundirgrein 	 undirgrein
eitthverjum 	 einhverjum
eittthvert 	 eitthvert
eldfjallafræðinga 	 eldfjallafræði
eldfjallafræðinga 	 eldfjallafræði
eldsneytinð 	 eldsneytið
elfur 	 elfr
elisfræðilögmál 	 eðlisfræðilögmál
elsa 	 elsta
embæti 	 embætti
endan 	 endann
endasvæði 	 endasvæðinu
endsneyti 	 eldsneyti
endunýja 	 endurnýja
endur-nefna 	 endurnefna
endurnýja 	 endunýja
endurnýtanlega 	 endurnýtanlegar
endurnýtanleg 	 endurnýjanlegri
endurnýtanlegir 	 endurnýtanlegri
endurnýtanlegt 	 endurnýtanlega
endurnýtanlegt 	 endurnýtanlegar
endurreist 	 endurreisna
endurspeglast 	 endurspegast
endurunnanlegt 	 endurvinnanlegt
endurunnanlegt 	 endurvinnanlegt
engjaskófaætt 	 engjaskófa
engjaskófaætt 	 engjaskófarætt
erðafræði 	 erfðafræði
erfðaauðlindum 	 erfðaauðlinda
erfðamengja 	 erfðamengjum
erfðamengja 	 erfðamengjum
erfðamengjum 	 erfðamengja
erfðamengjum 	 erfðamengja
erfðaupplýsingar 	 erfðaupplýsinga
erfðavejur 	 erfðavenjur
ericoideser 	 ericoides
ericoideser 	 ericoides
ersyðsti 	 syðsti
eskimó-aleúsku 	 eskimó-aleútísku
eskimó-aleutísk 	 eskimó-aleútísk
etrúskíska 	 etrúskneska
euhemerismi 	 evhemerismi
eutektisk 	 eutektísk
evanlísk-lúthersku 	 evangelísk-lúthersku
evrópu 	 evrópsku
eyarklasi 	 eyjaklasi
eyðimörkum 	 eyðimerkum
eyjunna 	 eyjuna
eyjuþyrpingu 	 eyjaþyrpingu
eyunni 	 eyjunni
fæddisst 	 fæddist
fædd­ist 	 fæddist
fæddurb 	 fæddur
fænda 	 frænda
faggildingu 	 faggyldingu
fáliðaðasta 	 fáliðasta
fán 	 fána
fán 	 fána
fangelsistilraunin 	 fangelsistilraun
fangelsistilraunin 	 fangelsistilraun
fánin 	 fáni
fánin 	 fáni
fánin 	 fáninn
fánin 	 fáninn
farsællasti 	 farsælasta
farsællasti 	 farsælasta
farstótt 	 farsótt
fátæktamat 	 fátæktarmatur
febrúarbylgina 	 febrúarbyltingina
feingar 	 fengar
feingar 	 fengar
félagfærni 	 félagsfærni
félaglynd 	 félagslynd
félagshagfræðilega 	 félagshagfræðilegu
félagskapur 	 félagsskapur
félagskordýr 	 félagsskordýr
félagslindir 	 félagslyndir
félagsskaps 	 félagsskapar
félagsþjónustu 	 félagsþjónusta
felmsturskast 	 felmturskast
felmsturskast 	 felmturskast
felmstursköst 	 felmtursköst
felmstursköst 	 felmtursköst
felmstursköstum 	 felmtursköstum
felmstursköstum 	 felmtursköstum
felmstursraskana 	 felmtursraskana
felmstursraskana 	 felmtursraskana
felmstursröskuninni 	 felmtursröskuninni
felmstursröskuninni 	 felmtursröskuninni
felmstursröskunum 	 felmtursröskunum
felmstursröskunum 	 felmtursröskunum
felstir 	 flestir
fengizt 	 fengist
fenjakrókudíllinn 	 fenjakrókódíllinn
fenjakrókudíllinn 	 fenjakrókódíllinn
ferhyrntar 	 ferhyrndar
feriðir 	 ferðir
ferilheildis´í 	 ferilheildis
fernigsfylki 	 ferningsfylki
ferningfylki 	 ferningsfylki
ferningfylki 	 ferningsfylki
fersentimeter 	 fersentimetri
fersentimetra 	 fersentímetra
ferskvatnsfiskarsem 	 ferskvatnsfiskar
ferskvatnsstöðuvötn 	 ferskvatnsstöðuvötnum
feskvatn 	 ferskvatn
fimmoddótri 	 fimmoddóttri
fimmoddótri 	 fimmoddóttri
fimtánda 	 fimmtánda
fimtánda 	 fimmtánda
fimti 	 fimmti
fingrabrettið 	 fingrabrettinu
fingrabrettið 	 fingrabrettinu
finnó-úgrískra 	 finnsk-úgrískra
finnó-úgrískra 	 finnsk-úgrískra
firrverandi 	 fyrrverandi
firstur 	 fyrstur
firstur 	 fyrstur
fiskveiðisjórnun 	 fiskveiðistjórnun
fjalægð 	 fjarlæg
fjallendi 	 fjalllendi
fjallent 	 fjalllent
fjallin 	 fjallið
fjallmennsku 	 fjallamennsku
fjallrætur 	 fjallsrætur
fjárfestingabankur 	 fjárfestingabanki
fjárhættspil 	 fjárhættuspil
fjarskild 	 fjarskyld
fjlótinu 	 fljótinu
fjöbreytt 	 fjölbreytt
fjöðum 	 fjöðrum
fjöggura 	 fjögurra
fjögura 	 fjögurra
fjölbreutum 	 fjölbreyttum
fjölbreytt 	 fjölbreyt
fjöldamótmæli 	 fjöldamótmælum
fjöldanetspunaleikur 	 fjölnotendanetspunaleikur
fjöldan 	 fjöldann
fjöldan 	 fjöldann
fjöldan 	 fjöldann
fjölgervisform 	 fjölgervingsform
fjölgervisform 	 fjölgervingsformum
fjölgevingsform 	 fjölgervingsform
fjölkskyldna 	 fjölskyldna
fjölkvæmnisfugl 	 fjölkvænisfugl
fjöllistarhópinn 	 fjöllistarhópsins
fjöllyfjameðferð 	 lyfjameðferð
fjöllyfjameðferð 	 lyfjameðferð
fjölmennasta 	 næstfjölmennasta
fjölmiðkum 	 fjölmiðlum
fjölskyldunar 	 fjölskyldunnar
fjölskylfum 	 fjölskyldum
fjölsnertiskjám 	 fjölsnertiskjáinn
fjölsnertiskjám 	 fjölsnertiskjáinn
fjölsylda 	 fjölskylda
fjölsylda 	 fjölskylda
fjölvínýlklóríð 	 fjölvínýlklóríðs
fjölvínýlklóríð 	 fjölvínýlklóríðs
fjórð 	 fjórða
fjöritíu 	 fjörutíu
fjörtum 	 fjötrum
fjörtum 	 fjötrum
fjrósömu 	 frjósömu
fjrósömu 	 frjósömu
flauels-djass 	 flauelsdjass
fleirri 	 fleiri
fleirri 	 fleiri
fleygð 	 fleyguð
fleygð 	 fleyguð
fleygrýnir 	 fleygrúnir
fleygrýnir 	 fleygrúnir
fliðrúm 	 firðrúm
fljölga 	 fjölga
fljótiu 	 fljótinu
flóaskel 	 flóaskelin
flóaskel 	 flóaskelin
flóðbygja 	 flóðbylgja
flokkræði 	 flokksræði
flokkunum 	 flokkinum
flöksuvatn 	 flöskuvatn
flöksuvatn 	 flöskuvatn
flótt 	 fljótt
flugatvika 	 flugatvik
flugfélag 	 flugfélagum
flugfélagum 	 flugfélag
flugmannin 	 flugmanninn
flúgvélaiðnaðarins 	 flugvélaiðnaðarins
flugvellum 	 flugvellinum
flugvellum 	 flugvöllum
flutningarhöfn 	 flutningahöfn
flutningarþyrlna 	 flutningarþyrlur
flutninsmáti 	 flutningsmáti
fluttninga 	 flutninga
fögurri 	 fagurri
foreldar 	 foreldra
forleifafræðinga 	 fornleifafræðinga
formerkisfalli 	 formerkisfallsins
formerkisfalli 	 formerkisfallsins
fórnarlambana 	 fórnarlambanna
fornarldarsögur 	 fornaldarsögur
forn-enska 	 fornenska
forn-grísku 	 forngrísku
fornheimspekinga 	 heimspekinga
fornleyfagröft 	 fornleifagröft
fornnorðurskautssvæðis 	 fornnorðurskautssvæðisins
fornöldum 	 fornöld
forn-persneska 	 fornpersneska
fornritafjelagsins 	 fornritafélagsins
forritnarmálinu 	 forritunarmálinu
forritnarmálinu 	 forritunarmálum
forritnarmálinu 	 forritunarmálunum
forritskódann 	 forritskóðann
forsætisráðherran 	 forsætisráðherrann
forsetisráðherra 	 forsætisráðherra
forth 	 fourth
förukóngulær 	 föruköngulær
forustustuðul 	 forystustuðul
forustustuðullinn 	 forystustuðullinn
foseti 	 forseti
fótbola 	 fótbolta
fótgönguliðsundrifylkja 	 fótgönguliðsundirfylkja
föurætt 	 föðurætt
frádreggnir 	 frádregnir
fræðiheiði 	 fræðiheiti
fræðimenskunnar 	 fræðimennskunnar
fræðitilgátuformi 	 fræðitilgátur
fræum 	 fræjum
fræum 	 fræjum
frálst 	 frjálst
frálst 	 frjálst
framandalegum 	 framandlegum
framburður 	 gð-framburður
framburður 	 hv-framburður
framburður 	 rl-framburður
framhalf 	 framhald
framhja 	 framhjá
framkvænd 	 framkvæmd
framleiðar 	 framleiðir
framleiðlan 	 framleiðslan
frammúrskarandi 	 framúrskarandi
framn 	 fram
framúrskaranda 	 framúrskarandi
fremdýrafræðingar 	 fremdardýrafræðingar
fremdýrafræðingar 	 fremdardýrafræðingar
friðargæslusveitir 	 friðargæslusveita
fríðartíma 	 fríðartímum
frjálslyndishugmyndir 	 frjálslyndishugmyndum
frjálslyndishugmyndir 	 frjálslyndishugmyndum
frjálslyndisstefnu 	 frjálslyndisstefnunnar
frjóðguð 	 frjóvguð
frjóguð 	 frjóvguð
frjósamann 	 frjósaman
frmlag 	 framlag
frönsku 	 frönska
frönsum 	 frönskum
frumbiggjamála 	 frumbyggjamála
frumbyggjatungumálum 	 frumbyggjatungumálunum
frumdýrinum 	 frumdýrinu
frumefnaformi 	 frumefnisformið
frumefnana 	 frumefnanna
frumindoevrópsku 	 frumindóevrópsku
frumindoevrópsku 	 frumindóevrópsku
frumkóta 	 frumkóða
frumkóta 	 frumkóða
frumkvöðulsstarfsemi 	 frumkvöðlastarfsemi
frumnnorrænu 	 frumnorrænu
frumsemdur 	 frumsemdum
frumsemdur 	 frumsemdum
frumsemdur 	 frumsemdum
frumsemdur 	 frumsendur
frumsemdur 	 frumsendur
frumsemdur 	 frumsendur
frumsemdur 	 frumsendur
frumsemdur 	 frumsendur
frumsemdur 	 frumsendur
frumsemdur 	 frumsendur
frumsemdur 	 frumsendur
frumsemdur 	 frumsendur
frumsemdur 	 frumsendur
frumsemdur 	 frumsendur
frumsemdur 	 frumsendur
frumsemdur 	 frumsendur
frumsk´ginum 	 frumskóginum
frumulíffær 	 frumulíffæri
frumulíffær 	 frumulíffæri
frumuskiftingu 	 frumuskiptingu
fullkomnlega 	 fullkomlega
fullorðina 	 fullorðinna
fullvedi 	 fullveldi
fullyrðignunni 	 fullyrðingunni
furugana 	 furigana
furutugund 	 furutegund
fylgiorðu 	 fylgiorða
fylgiorðu 	 fylgiorða
fyljar 	 fylgjar
fylkini 	 fylkinu
fyr 	 fyrr
fyrirækis 	 fyrirtækis
fyrirækis 	 fyrirtækis
fyrirbiggja 	 fyrirbyggja
fyrirlestrari 	 fyrirlesari
fyrirslestraraðir 	 fyrirlestraraðir
fyrirslestraraðir 	 fyrirlestraraðir
fyrirtækisinns 	 fyrirtækisins
fyrirtæki 	 te-fyrirtæki
fyritækja 	 fyrirtækja
fyritækja 	 fyrirtækja
fyrrveransi 	 fyrrverandi
fyrverandi 	 fyrrverandi
gæludýrafiskarnir 	 gælufiskarnir
gæludýrinn 	 gæludýrin
gagnsæðrar 	 gagnstæðrar
gamanvisur 	 gamanvísur
gamlann 	 gamlan
gamlinr 	 gamlir
garðyrkju-olía 	 garðyrkjuolía
gauksætt 	 gaukaætt
geðveikismálið 	 geðveikismál
gefinu 	 gefin
gegnheld 	 gegnheil
geimferðaáætlunin 	 geimferðaáætlun
geimferðarstofnun 	 geimferðastofnun
geimsluhólf 	 geymsluhólf
geislaveiki 	 geislavirkni
geislavirknisvopn 	 geislavirknivopn
geislvirkni 	 geislavirkni
gekkk 	 gekk
geklofa 	 geðklofa
gengdarlausa 	 gegndarlausa
gen 	 gene
geng-um 	 gengum
geng-um 	 gengum
genisins 	 gensins
gerr 	 gerir
gerr 	 gerir
gersdorffíti 	 gersdorfíti
ger-sveppi 	 gersveppi
gígarraðirnar 	 gígaraðirnar
gisti 	 gistis
gisti 	 gistis
gistis 	 gisti
gistis 	 gisti
gítargrunn 	 gítargrunni
gítarleikara 	 jazzgítarleikara
gítar-sóló 	 gítarsóló
gítarum 	 gítörum
gjaldgeri 	 gjaldkeri
gjaldgeri 	 gjaldkeri
gjaldmiðilsisn 	 gjaldmiðilsins
gjaldmiðl 	 gjaldmiðils
gjaldmiðl 	 gjaldmiðli
gjalmiðilssamstarfið 	 gjaldmiðilssamstarfið
gjörningaverkum 	 gjörningaverk
gjörvalt 	 gjörvallt
gjóskugígar 	 gjóskugíga
gleðiskapur 	 gleðskapur
gljándi 	 gljáandi
gljándi 	 gljáandi
glóaldinsætt 	 glóaldinætt
glóarþræði 	 glóðarþræði
glóðaþræði 	 glóðarþræði
glossularia 	 grossularia
glysþungarokksbanda 	 glysþungarokksbandanna
gnægtarhornið 	 gnægtahornið
golf-strauminum 	 golfstrauminum
gómfillan 	 gómfyllan
gosögnin 	 goðsögnin
gosopiniu 	 gosopinu
gosubergi 	 gosbergi
götudansstíls 	 götudansstíll
grá-blár 	 gráblár
grá-blátt 	 gráblátt
græningjaflokkinum 	 græningjaflokknum
græntmeti 	 grænmeti
grafarkirkja 	 graftarkirkja
gralinn 	 grallinn
gralurinn 	 gralinn
grannfræðilegar 	 grannfræðilegum
grannfræðilegum 	 grannfræðilegar
grantum 	 granatum
grasætt 	 grasaætt
grasætt 	 grasaætt
grasætt 	 grasaætt
grasafræðingnumw 	 grasafræðingnum
grátviðar 	 grátviðarætt
greinamerki 	 greinarmerki
greinamerki 	 greinarmerki
greinamur 	 greinarmunur
greinin 	 greinini
greinini 	 greinin
grimd 	 grimmd
gripörmonum 	 gripörmunum
gróðsetja 	 gróðursetja
gróðurhúsaloftegund 	 gróðurhúsalofttegund
grófrt 	 gróft
grókólfhirsla 	 kólfhirsla
grönnnum 	 grönnum
grugggrunge-hljómsveit 	 grunge-hljómsveit
grugg-sveitirnar 	 gruggsveitirnar
grunge-hreyfingunni 	 grugghreyfingunni
grunnaðgerðir 	 grunnaðgerðirnar
grunnvelli 	 grundvelli
grunvöllur 	 grundvöllur
grútarlampi 	 grottarlampi
gúanósínþrífosfat 	 adenósínþrífosfat
guðii 	 guði
gulfóstursfæðing 	 eggfóstursfæðing
gulfóstursfæðing 	 eggfóstursfæðing
gul-hvítur 	 gulhvítur
gúmmívörum 	 gúmmívörur
gyftast 	 giftast
gyftast 	 giftast
hæðsta 	 hæsta
hæðsta 	 hæsta
hægrissinnaður 	 hægrisinnaður
hægvaxa 	 hægvaxta
haemoglobin 	 hemoglobin
hænsnabúsins 	 hæsnabúss
hæt 	 hætt
hafnarboltanum 	 hafnarbolta
hafssvæðum 	 hafsvæðum
hágildispunktur 	 lággildispunktur
hagnaðarskini 	 hagnaðarskyni
hagstjón 	 hagstjórn
hagsvöxtur 	 hagvöxtur
hákarlategund 	 hákarlategundir
háksólanám 	 háskólanám
háksólanám 	 háskólanám
hálfkassagítarar 	 kassagítarar
hálfsmánaðarlegur 	 hálfsmánaðarlega
halluciantions 	 hallucinations
hálsnum 	 hálsinum
hálssins 	 hálsins
hálssins 	 hálsins
hámarkslengd 	 hámarksvegalengd
hamlaust 	 hamslaust
hamskifti 	 hamskipti
hanbók 	 handbók
handknattleiksdeildakerfið 	 karlahandknattleiksdeildakerfið
handrítið 	 handritið
han 	 hann
han 	 hans
hann 	 hanns
hann 	 hanns
hann 	 hanns
hanns 	 hann
hanns 	 hann
hanns 	 hann
hanns 	 hann
hanns 	 hann
hanns 	 hann
hanns 	 hans
hanns 	 hans
hanns 	 hans
hanns 	 hans
hanns 	 hans
hanns 	 hans
hanns 	 hans
hanns 	 hans
hanns 	 hans
hanns 	 hans
hanst 	 hans
»hapta 	 hapta
háreyst 	 háreist
háskólabókasafni 	 háskólabókasafns
háskólan 	 háskólann
haskóli 	 háskóli
háspennusnerta 	 háspennusnertur
hátiðaljómi 	 hátíðaljómi
háþróðaður 	 háþróaður
hebreiska 	 hebreska
hefbundnir 	 hefðbundnir
hefðbundin 	 óhefðbundin
hefr 	 hefur
hegðunnar 	 hegðunar
hegðunnar 	 hegðunar
heildarhnappurinn 	 heildarhnappinn
heilsuvandamál 	 heilsuvandamálum
heimalingar 	 heimaalningar
heimalingar 	 heimalningar
heimaríknir 	 heimaríkir
heimavist 	 heimavistnni
heimsfræðingur 	 eðlisfræðingur
»heimskastur 	 heimskastur
heimsstyrjöldinnialveg 	 heimsstyrjöldinni
heimsstyrjöldinni 	 heimstyrjöldinni
heimstryjöldina 	 heimstyrjöldina
heimstyrjalarinnar 	 heimsstyrjaldarinnar
heimstyrjaldarinnar 	 heimsstyrjaldarinnar
heimstyrjöld 	 heimsstyrjöld
heimstyrjöld 	 heimstyrjöldinni
heimstyrjöldina 	 heimsstyrjöldina
heimstyrjöldinni 	 heimsstyrjöldinni
heimstyrjöldinni 	 heimsstyrjöldinni
heimstyrjöldinni 	 heimsstyrjöldinni
heimstyrjöldinni 	 heimsstyrjöldinni
heimvöllur 	 heimavöllur
heiranlega 	 heyranlega
heitttrúaður 	 heittrúaður
helíumgassins 	 helíumgass
helögum 	 heilögum
helögum 	 heilögum
helögum 	 heilögum
hemglóbín 	 hemóglóbíni
hemisellulósa 	 hemísellulósa
hemoglobin 	 haemoglobin
hemóglóbíni 	 hemglóbín
hemoglóbínum 	 hemóglóbínum
hemspekingurinn 	 heimspekingurinn
henntar 	 hentar
hennt 	 hent
hentungur 	 hentugur
heppnaðis 	 heppnaðist
hérðassambandi 	 héraðssambandi
herin 	 herinn
herkænskur 	 herkænsku
herleiðangrum 	 herleiðöngrum
hernaðaleiðangur 	 hernaðaleiðangri
hernumnum 	 hernumdum
hernumnum 	 hernumdum
herskildir 	 herskyldir
herstöðum 	 herstöðvum
herstöðvarandstæðinga 	 herstöðvaandstæðinga
hérþjálfun 	 herþjálfun
hestasætt 	 hestaætt
hestinu 	 hestinum
hestsisn 	 hestsins
hetitinu 	 heitinu
hexacorallia 	 hexacorallia-ætt
heyrnalaust 	 heyrnarlausu
híeroglýfur 	 híeróglýfur
himkynni 	 heimkynni
hindanir 	 hindranir
hinns 	 hins
hip 	 hipp
hip 	 hipp
hip 	 hipp
hip 	 hipp
hip 	 hipp
hitaaukning 	 hitaukning
hitastiginn 	 hitastigið
hitavatnstönkunum 	 heitavatnstönkunum
hittitísku 	 hittísku
hjálmaskyldu 	 hjálmaskyldan
hjálpahunar 	 hjálpahundar
hjarastopp 	 hjartastopp
hjarðir 	 ihjarðir
hjómsveitin 	 hljómsveitin
hjómsveitini 	 hljómsveitina
»hjör 	 hjör
ĥjurt 	 jurt
hlapðvarpsþáttur 	 hlaðvarpsþáttur
hleyt 	 hleypt
hlífðarglerauguef 	 hlífðargleraugu
hljóðanum 	 hljóðönum
hljóð-effectum 	 hljóðeffektum
hljóðfær 	 hljóðfæri
hljóðfœraleik 	 hljóðfæraleik
hljóðnældur 	 hljóðsnældum
hljóðupökur 	 hljóðupptökur
hljómasveit 	 hljómsveit
hljómplatnaog 	 hljómplatna
hljómssveit 	 hljómsveit
hljómsveitarinnar 	 rokk-hljómsveitarinnar
hljómsveitina 	 hljósveitin
hljómsveitin 	 hljósveitin
hljómsveitir 	 indíhljómsveitir
hljómsveitir 	 indíhljómsveitir
hljósmveitarinnar 	 hljómsveitarinnar
hljósveitin 	 hljómsveitin
hljósveitin 	 hljómsveitina
hlóðfæri 	 hljóðfæri
hlóðstafrófinu 	 hljóðstafrófinu
hlómsveitir 	 hljómsveitir
hlosen 	 holosen
hlutaþrýstingur 	 hlutþrýstingur
hlýan 	 hlýjan
hlýlju 	 hlýju
hlýur 	 hlýtur
hofróðulegur 	 hofróðulegt
höfuborg 	 höfuðborg
höfuðbói 	 höfuðbólið
höfuðbol 	 höfuðból
höfuðdugðinni 	 höfuðdygðinni
hofuðið 	 höfuðið
höfundarétt 	 höfundaréttar
höfundsins 	 höfundarins
hófus 	 hófust
høgskole 	 høyskole
højskole 	 høgskole
højskole 	 høyskole
holdnúskur 	 holdhnúskar
hópuust 	 hópuðust
hövuðstaður 	 höfuðstaður
hraðsreiðasta 	 hraðskreiðasta
hræum 	 hræjum
hraunkleprarnis 	 hraunkleprarnir
hreindýrir 	 hreindýrin
hreyðrar 	 hreiðrar
hreyfadýra 	 hreifadýra
hreyfigar 	 hreyfingar
hreyfirfræðilega 	 hreyfifræðilega
hrikalaga 	 hrikalega
hröðinin 	 hröðunin
hröðinin 	 hröðunin
hröðunin 	 hröðinin
hrossahárum 	 hrossahári
hryðjuverkaárásunum 	 hryðjuverkaárásum
hryfnir 	 hrifnir
hryggleysinga 	 hryggleysingja
hryggleysingum 	 hryggleysingjum
hryggna 	 hrygna
hryggna 	 hrygna
hryggna 	 hrygna
hryggna 	 hrygna
hryggningarslóðir 	 hrygningarslóðir
hrygningafiskur 	 hrygningarfiskur
hryndjanda 	 hrynjanda
húðbakteríusamfélög 	 húðbakteríusamfélögum
húðkrabbameins 	 krabbameins
huðláts 	 húðláts
hugbúnaðarverkfræðingar 	 hugbúnaðarverkfræði
huggðist 	 hugðist
huggðist 	 hugðist
hugleiðingar 	 ef-hugleiðingar
hugprúðír 	 hugprúðir
hundað 	 hundrað
hundruða 	 hundraða
hundruði 	 hundruð
hundruði 	 hundruð
hungursneyðarinna 	 hungursneyðarinnar
húsaleiguni 	 húsaleigunni
hús­móður 	 húsmóður
hústónlistar 	 hústónlist
hústónlist 	 hústónlistar
hvenkynshirslur 	 kvenkynshirslur
hverastrýta 	 hverastrýtum
hverastrýtum 	 hverastrýta
hverfahluti 	 hverfishluti
hverning 	 hvernig
hvílftarjökull 	 hvilftarjökull
hvílftarjökuls 	 hvilftarjökuls
hvítarússnesku 	 hvítrússnesku
hydragyros 	 hydrargyros
hydroxíð 	 hýdroxíð
hynslóða 	 kynslóða
íbæta 	 bæta
iðnaðin 	 iðnaðinn
iðnbyltinginni 	 iðnbyltingunni
iðnværðingu 	 iðnvæðingu
iðuhvolfið 	 iðuhvolf
iðuhvolf 	 iðuhvolfið
iðullega 	 iðulega
íferðafall 	 íferðarfall
igdlu 	 iglu
iglu 	 igdlu
ilbreiður 	 illbreiður
illskyljanleg 	 illskiljanleg
indíánamál 	 indjánamál
indiehljómsveitir 	 indíhljómsveitir
indiependent 	 independent
indie-popparanna 	 indípopparanna
indie-poppararnir 	 indípoppararnir
indó-arísk 	 indóarísk
indó-íranskra 	 indóíranskra
indóírönskt 	 indóíranskt
innanfrumusníkla 	 innanfrumusníklum
innann 	 innan
innann 	 innan
innflitjenda 	 innflytjenda
innihaldur 	 inniheldur
innihelda 	 innihalda
innihelduer 	 inniheldur
innihelduer 	 inniheldur
innihelduer 	 inniheldur
innihelduer 	 inniheldur
innihöld 	 innihald
inninheldur 	 inniheldur
innnanbæjar 	 innanbæjar
innnanbæjar 	 innanbæjar
innn 	 inn
innybyggðum 	 innbyggðu
ins 	 hins
internetþáttunum 	 internetþættinum
intersectionalism 	 intersectionality
intersectionality 	 intersectionalism
inuítamál 	 inúítamál
íraks 	 írak
islandicaer 	 islandica
íslendkar 	 íslenskar
íslenska 	 íslenzka
íslenska 	 íslenzka
íslenska 	 íslenzka
ísllinsa 	 íslinsa
ísraelskru 	 ísraelsku
ítalska-abbesíska 	 ítalsk-abbesíska
ítalsk 	 ítalskt
jafnátt 	 jafnátta
jafnframa 	 jafnframt
jafnvægiskenninguna 	 jafnvægiskenningu
jafnvél 	 jafnvel
jafnvél 	 jafnvel
japansk 	 japanska
japöns 	 japönsk
jarðskálfta 	 jarðskjálfta
jarðskjálftafræðingar 	 skjálftafræðingar
járnbrautarstjórnandar 	 járnbrautarstjórnendur
járnsegulmögnuðu 	 járnsegulmögnuðum
jarnstandi 	 járnstandi
járn-þríhyrningurinn 	 járnþríhyrningurinn
jökular 	 jöklar
jóniskt 	 jónískt
jörðuna 	 jörðina
jugle 	 jungle
júgólslavnesku 	 júgóslavnesku
júkulele 	 úkulele
jurtæta 	 jurtaæta
jurtæta 	 jurtaæta
jurta-te 	 jurtate
jurtunni 	 jurtinni
kaffidrykkkur 	 kaffidrykkur
kaffidrykkkur 	 kaffidrykkur
kaffigerðarvélum 	 kaffigerðarvélar
kaffíns 	 koffíns
kaflan 	 kaflann
kaflan 	 kaflann
kalaallisut 	 kalaallit
kalaallit 	 kalaallisut
kalíumsalta 	 kalsíumsalta
kalkríkann 	 kalkríkan
kalksteinaklettar 	 kalksteinakletta
kalladir 	 kallaðir
kalsidon 	 kalsedon
kampavínsvínþúgurnar 	 kampavínsþrúgurnar
kandidat 	 kandídat
karamelskel 	 karamelluskel
karkyns 	 karlkyns
karótínlitarefna 	 karótínlitarefnum
kassagítarar 	 hálfkassagítarar
kastalan 	 kastalanum
kastilíanska 	 kastilíska
katalanska 	 katalónska
kathólskrar 	 kaþólskrar
kats 	 khats
kattadýra 	 kattardýra
kattarmatur 	 kattamatur
kaupmáttarjöfnuði 	 kaupmáttarjöfnuð
kaupmáttarjöfnuði 	 kaupmáttarjöfnuð
keðju 	 keðjun
keðjun 	 keðju
keðjurekjandi 	 keðjureykjandi
keltíberísk 	 kelt-íberísk
keltíberísk 	 kelt-íberísk
keltneksur 	 keltneskur
keltnenskri 	 keltnenskur
keltnenskri 	 keltneskri
keltnenskur 	 keltneskri
kendi 	 kenndi
kendur 	 kenndur
kenn­ara­prófi 	 kennaraprófi
kennisettningum 	 kennisetningum
kennslutæknir 	 kennslutækni
kent 	 kennt
keynesianisma 	 keynesisma
keyrslukóta 	 keyrslukóða
keyrslukóta 	 keyrslukóða
khisanmálunum 	 koisanmálunum
kilógram 	 kílógram
kílómeter 	 kílómetri
kínahverfi 	 kínahverfinu
kínahverfinu 	 kínahverfi
kindi 	 kindin
kippur-stríðið 	 kippúr-stríðið
kirkjunar 	 kirkjunnar
kirkjustadinn 	 kirkjustaðinn
kirkjustaðurá 	 kirkjustaður
kirtilvörturá 	 kirtilvörtur
kísilhnúðri 	 kísilhrúðri
kísiller 	 kísill
kjarnaeindar 	 kjarneindar
kjarnaeindar 	 kjarneindar
kjarnaflofnun 	 kjarnaklofnun
kjarnakrftanna 	 kjarnakraftanna
kjarnaorkuvopn 	 kjarnorkuvopn
kjarnaverkanna 	 kjarnaverkana
kjarneðlisfræðingi 	 kjarneðlisfræðing
kjarnorkustýristangir 	 kjarnorkustýristöngum
kjarnorku-vígbúnaðarkapphlaupið 	 kjarnorkuvígbúnaðarkapphlaupið
kjarnorkuvopn 	 kjarnaorkuvopn
kjemur 	 kemur
kjölfestu 	 kjölfestum
klarinett 	 klarínett
klasin 	 klasinn
klausturreglana 	 klausturreglnanna
klofningarvopn 	 klofnunarvopn
klofunarhljóð 	 klofnunarhljóð
klórdíoxíð 	 klórdíoxíðs
klórdíoxíð 	 klórdíoxíðs
klukkaturn 	 klukkuturn
knatspyrnu 	 knattspyrnu
knatspyrnu 	 knattspyrnu
knattsborðskúlur 	 knattborðskúlur
koarsúlfíðsteindin 	 koparsúlfíðsteindin
koddaskelina 	 koddaskelin
koddaskelin 	 koddaskelina
koffeinríkur 	 koffínríkur
kollakoppur 	 skollakoppur
koltvísíringi 	 koltvísýringi
koltvísíring 	 koltvísýring
kóngakrabbanum 	 gullkóngakrabbanum
kóngapeðsbyrjun 	 kóngspeðsbyrjun
kongótrommur 	 kóngótrommur
konsti 	 kosti
konungsdómsins 	 konungdómsins
kónungsins 	 konungsins
konúngs 	 konungs
konungsríkin 	 konungaríkin
konungsríki 	 smákonungsríki
konungssambanda 	 konungssamband
kónungurinn 	 konungurinn
konúngur 	 konungur
kóreískum-amerískum 	 kóreskum-amerískum
kóriander 	 kóríander
kornabreska 	 kornbreska
kortavarpana 	 kortavarpanir
kortavarpanir 	 kortavarpana
kosningakerfum 	 kosningakerfi
kosningakerfum 	 kosningakerfi
kostsnaði 	 kostnaði
krabbameins 	 húðkrabbameins
krabbans 	 krabbanns
krats 	 krafts
krókudílar 	 krókódílar
krókudílategund 	 krókódílategund
krókudílategund 	 krókódílategund
krókudíllinn 	 krókódíllinn
krókudíllinn 	 krókódíllinn
krónísk 	 krónísku
krónísk 	 krónísku
kröstugt 	 kröftugt
kúarbjöllur 	 kúabjöllur
kúarbjöllur 	 kúabjöllur
kúlutyggjóböndin 	 kúlutyggjóbönd
kumt 	 kummt
kumt 	 kummt
kúni 	 kúnni
»kunni 	 kunni
»kunni 	 kunni
kvændur 	 kvæntur
kveikara 	 kveikjara
kvenkynslíkana 	 kvenkynslíkama
kvennkyn 	 kvenkyn
kvennkyns 	 kvenkyns
kvígúkálfa 	 kvígukálfa
kvikarsilfur 	 kvikasilfur
kvikasilfuroxíð 	 kvikasilfuroxíði
kvikasilfursmagn 	 kvikasilfursmengun
kvikasilfursmengunin 	 kvikasilfursmengun
kvikmind 	 kvikmynd
kvikmind 	 kvikmynd
kvikmyndagerðafyrirtæki 	 kvikmyndafyrirtæki
kvikmynda-iðnaðinum 	 kvikmyndaiðnaðinum
kvikmyndaleikstjóri 	 kvikmyndaleikstjórii
kvikmyndaverðlaununun 	 kvikmyndaverðlaununum
kvikmyndym 	 kvikmyndum
kvikuþrýstingurinn 	 kvikuþrýstingur
kvimyndasýningum 	 kvikmyndasýningum
kynbótadóma 	 kynbótamat
kynbótamat 	 kynbótadóma
kynjamismunum 	 kynjamismunun
kynþáttamismunar 	 kynþáttamismunun
kynþáttamismunun 	 kynþáttamismunar
kynþroksa 	 kynþroska
kynþrosta 	 kynþroska
kýrillíska 	 kýrillísku
kýrillísku 	 kýrillíska
kysnlóð 	 kynslóð
lægja« 	 lægja
læknifræði 	 læknisfræði
læknng 	 lækning
laggði 	 lagði
laggður 	 lagður
laggður 	 lagður
lággildispunktur 	 hágildispunktur
lággjaldaflugfélögum 	 lággjaldaflugfélög
laggt 	 lagt
landafræðislega 	 landafræðilegri
land 	 and
landbúnaðir 	 landbúnaði
landfræðilegru 	 landfræðilegri
landgögnuliðið 	 landgönguliðið
landmæri 	 landamæri
landmærinu 	 landmærunum
landnámsmannana 	 landnámsmannanna
landshlutinum 	 landshlutanum
landshlutinum 	 landshlutanum
landshlutinum 	 landshlutanum
landshlutur 	 landshluta
landshlutur 	 landshlutum
landsisn 	 landsins
landssvæði 	 landsvæði
landsvæði 	 landssvæði
langdysjur 	 langdysjar
langningu 	 lagning
län 	 läns
läns 	 län
lantaníð 	 lantaníði
lanveitandi 	 lánveitandi
lasana 	 lasagna
latínsegl 	 latínarsegl
latínubækr 	 latínubækur
latneksu 	 latnesku
laufblðð 	 laufblöð
lávaxinn 	 lágvaxinn
lávaxinn 	 lágvaxinn
leggangaþurrka 	 leggangaþurrki
legst 	 leggst
legst 	 leggst
legst 	 leggst
leiðbieiningum 	 leiðbeiningum
leiðir 	 leiðir‘
leiðtogaskóli 	 leiðtogaháskóli
leikastýra 	 leikstýra
leikjafamleiðundum 	 tölvuleikjafamleiðundum
leiklistaskóla 	 leiklistarskóla
leik­rit 	 leikrit
leiksskóla 	 leikskóla
leiksskóla 	 leikskóla
leikurun 	 leikurum
leikurun 	 leikurum
leisstýrð 	 leikstýrð
leitogi 	 leiðtogi
leitogi 	 leiðtogi
léka 	 lék
lestarökutæki 	 lestarökutækja
leucophelbeia 	 leucophlebia
leyðinni 	 leiðinni
leyndarsómsfulla 	 leyndardómsfulla
lfræðiheiti 	 fræðiheiti
lggja 	 liggja
lggja 	 liggja
liðinnu 	 liðinu
liðmót 	 liðamót
liðskiftir 	 liðskiptir
liðsstjórnandinn 	 leikstjórnandinn
lífeldnseyti 	 lífeldsneyti
lífetanól 	 lífmetanól
lifia 	 lifa
lífmetanól 	 lífetanól
lífræðigreinina 	 líffræðigreinina
lifrinar 	 lifrinnar
lifrustiginu 	 lirfustiginu
lifrustig 	 lirfustig
lífsins 	 lífssins
lífsseigt 	 lífseigt
lífstíl 	 lífsstíl
lífstíl 	 lífsstíll
lifurvandamál 	 lifrarvandamáli
lifurvandamál 	 lifrarvandamáli
lífveruru 	 lífverur
liggji 	 liggi
liggji 	 liggi
líkamslegt 	 líkamlegt
likillin 	 lykillin
líkindafræðinar 	 líkindafræði
líkindafræðinar 	 líkindafræði
listamannalaua 	 listamannalauna
listamannanýlenda 	 listamannanýlendu
litaafbrygði 	 litaafbrigði
litningaenda 	 litningsenda
lítríkum 	 litríkum
littli 	 litli
littli 	 litli
littlu 	 litlu
littlum 	 litlum
littlum 	 litlum
liturinn 	 liturinnn
liturinn 	 liturinnn
liturinnn 	 liturinn
liturinnn 	 liturinn
ljóðbækur 	 ljóðabækur
ljósfræðileg 	 ljósfræðilegt
ljósgrábrúnn 	 ljósgrábrúnir
ljósleiðaranet 	 ljósleiðaraneti
ljóstillífunarlagi 	 ljóstillífunarbelti
loðréttum 	 lóðréttum
loðréttum 	 lóðréttum
loðréttum 	 lóðréttum
loðréttum 	 lóðréttum
loftfyrrtar 	 loftfirrtar
loftfyrrtu 	 loftfirrtu
loftfyrrtum 	 loftfirrtum
loftlagsbreytingar 	 loftslagsbreytingar
loftlagsbreytingar 	 loftslagsbreytingar
loftlagsfræðingum 	 loftslagsfræðingum
loftlagsfræðingum 	 loftslagsfræðingum
loftslagsbelti 	 loftslagsbeltum
löggðu 	 lögðu
löggjafavalds 	 löggjafarvalds
lögjafaþingi 	 lögjafarþingi
lögmálí 	 lögmál
lögsagnarumbæmi 	 lögsagnarumæmi
lögsögumaður 	 lögumaður
lögunbum 	 lögunum
lögþingsformaður 	 lögþingsformaðurinn
lokaáhlaup 	 lokaáhlaupi
lotningafullt 	 lotningarfullt
lundaseyði 	 lundaseiði
lýdíska 	 lidíska
lýðvelsis 	 lýðveldisins
lýgileg 	 lygileg
lýgileg 	 lygileg
lyktarskin 	 lyktarskyn
lýsngu 	 lýsingu
mafjármálastarfssemi 	 fjármálastarfssemi
mahayana 	 mahajana
majónesi 	 majonesi
majónsósa 	 majonsósa
málaðarlegt 	 mánaðarlegt
málamiðlannavandamálinu 	 málamiðlanavandamálinu
malinka 	 maninka
málmfilmu 	 málmfilma
málmfræðingur 	 sálfræðingur
málminnihlutahópum 	 málminnihlutahóp
málmunga 	 málmungar
málmungar 	 málmunga
maltað 	 ómaltað
maltaður 	 ómaltaður
málýskur 	 mállýskur
málýskur 	 mállýskur
maninka 	 malinka
mannarfbótasinna 	 arfbótasinna
mannfjelaginu 	 mannfélaginu
mannlíkamanum 	 mannlíkamann
mannsugu 	 mannsaugu
mantrayana 	 tantrayana
maoría 	 maoríska
maoríska 	 maoría
margbretyilegu 	 margbreytilegu
margbreytileg 	 myndmargbreytileg
margliða 	 margliðan
margliðan 	 margliða
marglitturnar 	 marglytturnar
marglituð 	 marglit
marglötungum 	 margflötungum
marglyttutegund 	 marglyttutegundin
margsinnið 	 margsinnis
maríneringu 	 maríneringar
maríneringu 	 maríneringunni
maríneringuna 	 maríneringunni
marjúana 	 marijúana
markaðsettir 	 markaðssettir
markasetti 	 markaðssetti
markíll 	 makríll
markmiö 	 markmið
markmiö 	 markmið
marktækt 	 marktekt
markverdir 	 markverðir
massaminna 	 massaminni
mastersgráði 	 mastersgráðu
matarlist 	 matarlyst
matarræði 	 mataræði
matmikklum 	 matmiklum
matvöruverslunarkeðja 	 matvöruverslanakeðja
mávategund 	 máfategund
meðal-atómmassi 	 meðalatómmassi
meðallegnd 	 meðallengd
meðallíftíma 	 meðallíftímann
meðaltalsatómmassi 	 meðalatómmassi
meða 	 með
meðfera 	 meðferða
meðferðaer 	 meðferða
megilandi 	 meginlandi
meginn 	 megin
meginn 	 megin
meginn 	 megin
meginn 	 megin
meginn 	 megin
meiðlsa 	 meiðsla
meiginladið 	 meginlandið
meinvörpun 	 meinvörpum
meirihluta-flokkunm 	 meirihlutaflokkunum
»meiri 	 meiri
meislingasótt 	 mislingasótt
mekir 	 merkir
melodíum 	 melódíum
mengjafræðinar 	 mengjafræðinnar
mennig 	 menning
menningamálaráðherra 	 menningarmálaráðherra
menningamálastjóri 	 menningarmálastjóri
menntasofnun 	 menntastofnun
menntskóli 	 menntaskóli
menntunarkerfum 	 menntakerfum
mentir 	 menntir
merkingarvefum 	 merkingarvefjum
metorðið 	 metorði
metorði 	 metorðið
mettnar 	 metnar
mettunareimþrýstingur 	 mettunarþrýstingur
metylenbláu 	 metýlenbláu
metýlínblátt 	 metýlenblátt
metýlínbláu 	 metýlenbláu
metýlínbláu 	 metýlenbláu
miðbaut 	 miðbaug
miðjann 	 miðjan
miðjann 	 miðjan
miðjann 	 miðjan
miðjarðahafs 	 miðjarðahafslönd
miðjustjórninni 	 miðstjórninni
miðstöðvun 	 miðstöðvum
miðvitaða 	 meðvitaða
mikilfenglri 	 mikilfenglegri
mikin 	 mikinn
mikin 	 mikinn
mikklir 	 miklir
mikklu 	 miklu
mikklum 	 miklum
milimetrum 	 millimetrum
millímetra 	 millimetra
millim 	 milli
milljarðasti 	 milljarðasta
mindast 	 myndast
míníósk 	 mínóísk
minnuhlutamál 	 minnihlutamál
minst 	 minnst
minstu 	 minnstu
mirkraöflin 	 myrkraöflin
misævis 	 miðsævis
mishollir 	 mishollur
mislingasótt 	 meislingasótt
mislingasótt 	 mislitasótt
mislitasótt 	 mislingasótt
mismunanda 	 mismunandi
mismunani 	 mismunandi
misti 	 missti
míxtúra 	 míxtúru
mjaldi 	 mjaldri
mjólkursykur 	 mjólkursykuróþol
mjólkursykursóþol 	 mjólkursykuróþol
mjö 	 mjög
molybdenum 	 molybdenums
mónasítssandi 	 mónasítsandi
monsúnkomunnar 	 monsúnkomunni
mótannir 	 mótanir
mótmælandatrú 	 mótmælendatrú
mótmælandatrú 	 mótmælendatrúar
mozarella 	 mozzarella
muehlenbergii 	 muhlenbergii
muhlenbergii 	 muehlenbergii
munaðarleysingjahæli 	 munaðaleysingjahæli
munaðarleysingjanns 	 munaðarleysingjans
mydön 	 myndön
myndalegur 	 myndarlegur
myndanum 	 myndönum
myndarinar 	 myndarinnar
myndarlegasem 	 myndarlega
myndasöguasería 	 myndasögusería
myndasöguhöfundinn- 	 myndasöguhöfundinn
myndbreytingarbergfræði 	 myndbreytingarbergsfræði
myndinar 	 myndir
myndinn 	 myndin
myndirer 	 myndir
mynd­list­ar­manns 	 myndlistarmanns
myndsögublöðum 	 myndasögublöðum
myndst 	 myndast
mynnni 	 mynni
myntkörfulánin 	 myntkörfulán
mýrarlerki 	 mýralerki
mýrarlerki 	 mýralerki
myrkru 	 myrku
myslnublöndunni 	 mylsnublöndunni
nábílismanns 	 nábýlismanns
næringafræði 	 næringarfræði
næringaríkri 	 næringarríkri
nærststærsta 	 næststærsta
nærststærst 	 næststærst
nærststærstu 	 næststærstu
næstærsta 	 næststærsta
náms- 	 náms
nánst 	 nánast
náqrannabæjir 	 nágrannabæir
nasaholana 	 nasaholanna
náskildar 	 náskyldar
náskilt 	 náskylt
nátengra 	 nátengdra
natrínhýdroxíð 	 natríumhýdroxíð
natríumhýdroxíð 	 natrínhýdroxíð
náttúnni 	 náttúrunni
náttúrinni 	 náttúrunni
náttúrinni 	 náttúrunni
náttúrinni 	 náttúrunni
náttúrnni 	 náttúrunni
nátturulega 	 náttúrulega
nátturulegan 	 náttúrlegan
nátturuleg 	 náttúruleg
nátturuleg 	 náttúruleg
nátturulegt 	 náttúrlegt
nátturunnar 	 náttúrunnar
nátturunni 	 náttúrunni
nátturuval 	 náttúruval
náttúruvísindaleg 	 náttúruvísindalega
neanderdalsmennina 	 neanderdalsmenn
neanderdalsmenn 	 neanderdalsmennina
neða 	 eða
neðalstór 	 meðalstór
neða 	 neðan
neðangreinndu 	 neðangreindu
nefdarstörfum 	 nefndarstörfum
nefhjlóða 	 nefhljóða
nefmæld 	 nefmælt
neiddur 	 neyddur
nemandafélag 	 nemendafélag
nemandafélag 	 nemendafélag
nemandafélag 	 nemendafélag
nemandafélag 	 nemendafélag
netvafrarann 	 netvafrann
netþráðlausu 	 þráðlausu
neytaði 	 neitaði
neytandum 	 neytendum
nigerkongó 	 nígerkongó
nikkólít 	 nikkólíti
nílendustjóri 	 nýlendustjóri
nítróglyserín 	 nítróglyseríns
níuda 	 níunda
nivkí 	 nivk
nivk 	 nivkí
nokkura 	 nokkurra
nokkuri 	 nokkurri
nontett 	 nonett
noraðir 	 notaðir
norðasutur 	 norðaustur
norðraustri 	 norðaustri
norðsins 	 norðursins
norðsnjáldri 	 norðursnjáldri
norð-vestri 	 norðvestri
norðvestum 	 norðvestur
norðvesturhlusta 	 norðvesturhluta
norvesturhluta 	 norðvesturhluta
notandaviðmót 	 notendaviðmót
november 	 nóvember
núerandi 	 núverandi
núerandi 	 núverandi
núlíðnandi 	 núlíðandi
núllbaugi 	 núllbaug
numbers 	 number´s
númmer 	 númer
núningseldspýta 	 núningseldspýtan
nútímasagnfræðingurinn 	 nútímasagnfræðingar
ný-frjálshyggjuna 	 nýfrjálshyggjuna
nýji 	 nýi
nýjir 	 nýir
nykurætt 	 nykruætt
nýnorskunar 	 nýnorskunnar
nyrðsta 	 nyrðsti
nyrðsta 	 nyrsta
nyrðst 	 nyrst
óakveðna 	 óákveðna
óárreittar 	 óáreittar
óbygð 	 óbyggð
occipitial 	 occipitalis
óendurnýtanleg 	 óendurnýjanleg
offtast 	 oftast
offtast 	 oftast
offtast 	 oftast
offtast 	 oftast
ófleyhir 	 ófleygir
ofsarlega 	 ofsalega
ofstast 	 oftast
oftas 	 oftast
öfuggi 	 öfuguggi
ofurnáttúrulegrar 	 yfirnáttúrulegrar
ófyrirjáanlegur 	 ófyrirsjáanlegt
óhefðbundin 	 hefðbundin
óhefðbundin 	 óhefðbundnar
óhreyna 	 óhreina
óhreynindum 	 óhreinindum
óhugnaðlega 	 óhugnanlega
ójönunni 	 ójöfnunni
ókeipis 	 ókeypis
okkars 	 okkar
október-stríðið 	 októberstríðið
ókyrðin 	 ókyrrðin
ólífu-grænt 	 ólífugrænt
ólíulampa 	 olíulampa
ólömætum 	 ólögmætum
ómaltað 	 maltað
ómaltað 	 ómaltaður
ómaltaður 	 maltaður
ómaltaður 	 ómaltað
omfl 	 ofl
ömmuferningur 	 ömmuferningum
ónæmisfræðingi 	 ónæmisfræðingur
óneitanelga 	 óneitanlega
óneitnalega 	 óneitanlega
opinpert 	 opinbert
óráðanlegur 	 óráðanlegar
órafmögnuð 	 rafmögnuð
orðasafnsins 	 orðasafnsinu
öreindahraðall 	 eindahraðall
óreirðum 	 óeirðum
örgjörfa 	 örgjörva
örgjörfa 	 örgjörva
örgjörfa 	 örgjörva
örgjörfinn 	 örgjörvinn
örgjörfum 	 örgjörvum
örgjörfum 	 örgjörvum
örgjörva 	 örgjörvan
oriðið 	 orðið
oriðið 	 orðið
oriðið 	 orðið
oriðið 	 orðið
origani 	 origami
orkudrykkin 	 orkudrykkinn
orkuframleiðslu 	 vatnsorkuframleiðslu
orkuuppspretta 	 orkuuppsprettu
örorkulífeyribóta 	 örorkulífeyrisbóta
örsmæðarreikningi 	 örsmæðareikningi
örvamdi 	 örvandi
örvuna 	 örvun
ör-þörunga 	 örþörunga
ósjálfrátt 	 ósjálfrát
óskarað 	 óskaraða
óskarað 	 óskaraða
óskíska 	 oskíska
öskudreifjar 	 öskudreif
öskudreifjar 	 öskudreif
ósyntir 	 ósyndir
ótrúðverðugar 	 ótrúverðug
óvinskap 	 óvinskapar
oþann 	 þann
paleó-síberískra 	 paleósíberískra
paracetamóls 	 parasetamóls
pastúnska 	 pastúnsk
pastúnsk 	 pastúnska
peróna 	 persóna
perónuna 	 persónuna
perskneska 	 miðperskneska
perskneska 	 miðperskneska
persnensku 	 persnesku
persónueiginleika 	 persónueiginleikum
philosophikal 	 philosophical
picaro 	 picar
picaro 	 picar
pidgeonhole 	 pigeonhole
pílagrímaleið 	 pílagrímaleiðir
pincher 	 pinscher
pingyin 	 pinyin
pínulittlar 	 pínulitlar
pínulittlar 	 pínulitlar
pípunefjaætt 	 pípunefja
pira 	 pra
piscatoriuser 	 piscatorius
plasbarki 	 plastbarki
plebeirarnir 	 plebeiarnir
pleósentímabilinu 	 pleiósentímabilinu
plöntuleyfar 	 plöntuleifar
plöntuleyfum 	 plöntuleifum
plötuklædda 	 plötuklæddan
plötuklædda 	 plötuklæddan
plötuskilja 	 plötuskil
pólísk 	 pólitísk
pólitiskri 	 pólitískri
pólitiskum 	 pólitískum
pólýesteraþráðum 	 pólýesterþráðum
pomello 	 pomelo
pomello 	 pommelo
pomelo 	 pomello
pomelo 	 pommelo
pommelo 	 pomello
pommelo 	 pomelo
pommelo 	 pommeló
pommelo 	 pummelo
pönktonlistar 	 pönktónlistar
popp-hljómsveit 	 popphljómsveit
pop-rokk 	 popp-rokk
post-pönk 	 póst-pönk
pra 	 pera
prgrammable 	 programmable
professor 	 prófessor
prófessór 	 prófessor
prónum 	 prjónum
pummelo 	 pommelo
rababara 	 rabarbara
ráðgajafarfyrirtæki 	 ráðgjafarfyrirtæki
raðgreiningaraðferð 	 raðgreiningaraðferða
ráðherran 	 ráðherrann
ráðherran 	 ráðherrann
rækjunar 	 rækjurnar
ræktunarafbriðgi 	 ræktunarafbrigði
rafhlaðann 	 rafhlaðan
rafseglulkraf 	 rafseglulkraft
rafsegulsgeislun 	 rafsegulgeislun
rafstaum 	 rafstraum
ragnarrökum 	 ragnarökum
ragnarrökum 	 ragnarökum
rakarafrumvarpið 	 rakarafrumvarpinu
rán-bjalla 	 ránbjalla
rank 	 rak
ranlega 	 ranglega
rannsóknarháskóla 	 rannsóknaháskóla
rannsóknarlögregluforingjan 	 rannsóknarlögregluforingjann
rannsónir 	 rannsóknir
ran 	 rann
ransóknarmann 	 rannsóknarmann
ratsjárskjáum 	 ratsjárskjám
rauðumn 	 rauðum
reiðurbúin 	 reiðubúin
reikingum 	 reykingum
reiknrit 	 reiknirit
reiknrit 	 reiknirit
reitmynstri 	 reitamynstri
remolaði 	 remúlaði
rennilásina 	 rennilásinn
republikanir 	 repúblikanar
rétthrynda 	 rétthyrnda
rifbenin 	 rifbeinin
rifbenin 	 rifbeinin
ríkisatkvæðagreiðslu 	 fylkisatkvæðagreiðslu
ríkisatkvæðagreiðslu 	 fylkisatkvæðagreiðslu
ríkisneyðslu 	 ríkisneyslu
ríkístjórninni 	 ríkistjórninní
ríkistjórnum 	 ríkisstjórnum
risakini 	 risakyni
rithöfundin 	 rithöfundinn
rithöfundin 	 rithöfundinn
ritsjóra 	 ritstjóra
rit­verka 	 ritverk
rjóma-gulur 	 rjómagulur
rocknroll 	 rock’n’roll
rófunnar 	 rófunar
rógburðs 	 rógburð
rokkabillí 	 rokkabillís
rokkarisveit 	 rokksveit
rokke 	 rokk
rokke 	 rokk
rokk-hljómsveit 	 rokkhljómsveit
rokksveirarinnar 	 rokksveitarinnar
rökkurdýr 	 rökkursdýr
rökkursdýra 	 rökkurdýra
röksemdafærslu 	 röksemdafærslur
röksemdafærslu 	 röksemdafærslur
röksemdafærslur 	 röksemdafærslu
röksemdafærslur 	 röksemdafærslu
rómverksum 	 rómverskum
rómverksum 	 rómverskum
rómversk-kaþólksi 	 rómversk-kaþólski
rómversk-kaþólksi 	 rómversk-kaþólsku
röntgengeislavélar 	 röntgengeislavélum
rugbrauð 	 rúgbrauð
rúmmali 	 rúmmáli
rúnugaldri 	 rúnagaldri
rúnugöldrum 	 rúnagöldrum
rússnesksovétisk 	 rússnesk-sovésk
rúþen-mólybden 	 rúten-mólybden
rúþenoxíði 	 rútenoxíði
rúþensambönd 	 rútensambönd
ryðfríðu 	 ryðfríu
ryðfríðu 	 ryðfríu
sæðisfræum 	 sæðisfrumum
safnaðarinns 	 safnaðarins
sagð 	 sagði
sagnfræðskólanum 	 sagnfræðiskólanum
sakmvæmt 	 samkvæmt
sálaraflskennignar 	 sálaraflskenningar
sálfræðarnnar 	 sálfræðinnar
sálfræðimeðferðum 	 sálfræðimeðferð
sálfræðingur 	 málmfræðingur
salgæti 	 sælgæti
saltpétursýrunnar 	 saltpéturssýrunni
saltpétursýru 	 saltpéturssýru
samansettur 	 samansett
sambandríkisins 	 sambandsríkisins
samegilegra 	 sameiginlegra
sameinadist 	 sameinaðist
sameindarbyggingu 	 sameindabyggingu
sameindarstigi 	 sameindastigi
sameinginleg 	 sameiginleg
sameinigu 	 sameiningu
sámfélögum 	 samfélögum
samgöngusamninga 	 samgöngusamning
samhegislausu 	 samhengislausu
samkynheigðar 	 samkynhneigðar
samleikona 	 samleikkona
samlífislífverur 	 samlífislífverum
samnendri 	 samnefndri
samóíska 	 samóska
samóyedíska 	 samójedíska
samræmismat 	 samræmismati
samskifti 	 samskipti
samskiptamunstur 	 samskiptamynstur
samstendur 	 samanstendur
samstepystjórn 	 samsteypustjórn
samtakahyggju 	 samtakahyggjan
samtakann 	 samtakanna
samtíðalýsingu 	 samtíðarlýsingu
sannleiksumsögninni 	 sannleiksumsögn
sannleiksumsögninni 	 sannleiksumsögnin
sannleiksumsögnin 	 sannleiksumsögn
sannleiksumsögnin 	 sannleiksumsögninni
satyrixon 	 satyrikon
sauðfjárræktarreppur 	 sauðfjárræktarhreppur
sauðmjólk 	 sauðamjólkur
saurinum 	 saurnum
savants 	 sçavans
savönuni 	 savönnuni
saxafónn 	 saxófónn
saxófónaro 	 saxófónar
saxófónaro 	 saxófónar
sáþekkt 	 áþekkt
sçavans 	 savants
sebtett 	 septett
sebtett 	 sextett
sedursviður 	 sedrusviður
segji 	 segi
selenium 	 seleniums
séleyfishöfum 	 sérleyfishöfum
seljanda¹ 	 seljanda
sellúósa 	 selluósa
semitískum 	 semískum
sendinefdn 	 sendinefnd
serbo-króatískar 	 serbókróatískar
serbo-króatísku 	 serbókróatísku
sérhljóðasá 	 sérhljóða
sérhljóðasá 	 sérhljóða
sérsakt 	 sérstakt
sérsrhvers 	 sérhvers
sérstafsetningareglur 	 stafsetningarreglur
sérstakleg 	 sérstaklega
sérstak 	 sérstaka
sérstk 	 sérstak
sér¬verkefnin 	 sérverkefnin
sérþekkingarfyrirtæki 	 þekkingarfyrirtæki
sérþekkingarfyrirtæki 	 þekkingarfyrirtæki
setbergfræði 	 setbergsfræði
setninginn 	 setningin
shaddick 	 shaddock
shaddock 	 shaddick
shía-múslimar 	 sjía-múslimar
shía 	 shíta
shintotrúar 	 sjintotrúar
siðaskifti 	 siðaskipti
siðaskifti 	 siðaskipti
siðaskiftum 	 siðaskiptum
siðaskiptinn 	 siðaskiptin
siðasti 	 síðasti
síðfornaldar 	 fornaldar
siðfræðinar 	 siðfræðinnar
síðrokk 	 síðrokks
síðrokks 	 síðrokk
siglingafræða 	 siglingafræði
siglingarleiðinni 	 siglingarleiðin
sikileyksu 	 sikileysku
silfur-gráan 	 silfurgráan
silfuri 	 silfri
silíkat-steind 	 sílíkatsteind
sini 	 sinni
sinó-tíbetskt 	 sinó-tíbeskt
sírskotun 	 skírskotun
sí-smækkandi 	 sísmækkandi
sítronusafa 	 sítrónusafa
sjáfarguðinn 	 sjávarguðinn
sjálboðastarfi 	 sjálfboðastarfi
sjaldann 	 sjaldan
sjaldnarar 	 sjaldnar
sjálfkraka 	 sjálfkrafa
sjálfmorð 	 sjálfsmorð
sjálfmyndar 	 sjálfsmyndar
sjálfsdáðun 	 sjálfsdáðum
sjálfstæðisdag 	 sjálfstæðisdegi
sjálfstæðisdag 	 sjálfstæðisdegi
sjálfstýru 	 sjálfstýrðu
sjálfsvígstirlaunir 	 sjálfsvígstilraunir
sjalgæft 	 sjaldgæf
sjálsprottinn 	 sjálfsprottinn
sjálstætt 	 sjálfstætt
sjánlegri 	 sjáanlegri
sjárútvegsfyrirtæki 	 sjávarútvegsfyrirtæki
sjávarfalla-millur 	 sjávarfallamyllur
sjóin 	 sjóinn
sjóin 	 sjóinn
sjó–laxinn 	 sjólaxinn
sjó­manns 	 sjómanns
sjónframsetningu 	 framsetningu
sjónvarpsmyndinn 	 sjónvarpsmyndinni
sjónvarpsmyndinn 	 sjónvarpsmyndin
sjónvarpsþættinum 	 sjónvarpsmþættinum
sjónvilluu 	 sjónvillu
sjórn 	 stjórn
skáldskap 	 spáskáldskap
skáld­sög­ur 	 skáldsögur
skalotlauki 	 skalottlauk
skammstöfnun 	 skammstöfun
skamstöfun 	 skammstöfun
ska 	 skal
skattagrið 	 skattgriða
skattainheimtu 	 skattheimtu
skattarannsókna 	 skattrannsókna
skattgriða 	 skattagrið
skattheimtunnar 	 skattheimtunar
skautasvæði 	 skautasvæðið
skelskrifta 	 skeljaskrifta
skeppnur 	 skepnur
skibshræ 	 skipshræ
skíðihvala 	 skíðishvala
skiftir 	 skiptir
skiftist 	 skiptist
skildunámi 	 skyldunámi
skildunámi 	 skyldunámi
skildur 	 skyldur
skilníng 	 skilning
skiltist 	 skiptist
skindilega 	 skyndilega
skipulagaðar 	 skipulagðar
skívunni 	 skífunni
skívunni 	 skífunni
skjalasniða 	 skjalasnið
skjaldarberar 	 skjaldberar
skjöldin 	 skjöldinn
skllningi 	 skilningi
skoðannir 	 skoðanir
skoðannir 	 skoðanir
skógarlaust 	 skóglaust
skógarreitir 	 skógarreiti
skólafélugunum 	 skólafélögunum
skólan 	 skólann
skólan 	 skólann
skólan 	 skólann
skólan 	 skólann
skólan 	 skólann
skólan 	 skólann
skólan 	 skólann
skólan 	 skólann
skólan 	 skólann
skólin 	 skóli
skólin 	 skólinn
skólnn 	 skólann
skotkonungs 	 skautkonungs
sköttunu 	 sköttunum
skötuættbálk 	 skötuættbálki
skráarkerfi 	 skráakerfi
skráarsniðið 	 skráarsnið
skráarsnið 	 skráarsniðið
skráningartækið 	 skráningartæki
skráningartæki 	 skráningartækið
skrárir 	 skráir
skratskrift 	 skrautskrift
skreitt 	 skreytt
skriafði 	 skrifaði
skrifuðu 	 skrifu
skrifuðu 	 skrifu
skrölorm 	 skröltorm
skrýmsli 	 skrímsli
skurðahnífar 	 skurðarhnífar
skutinum 	 skutnum
skyldleykalaust 	 skyldleikalaust
skylningshæfni 	 skilningshæfni
skýringarstíl 	 skýringastíl
skýringastíl 	 skýringarstíl
skýrlsur 	 skýrslur
slagverkshljóðfærum 	 slagverkshljóðfæra
slesíska 	 slésíska
slesísk 	 slésísk
slesísku 	 slésísku
slíðrastörin 	 slíðrastör
slíðrastör 	 slíðrastörin
slittróttar 	 slitróttar
slöngvivaður 	 slönguvaður
smásæar 	 smásæjar
smáskífuni 	 smáskífunni
smáyddur 	 smáyddir
snajllúr 	 snjallúr
snériltrommum 	 sneriltrommum
snjókrabbi 	 snjókrabba
snjónbaug 	 sjónbaug
snjósleða 	 sjósleða
snjóþungt 	 snjóþúngt
snorku 	 snorklu
snýkjudýr 	 sníkjudýr
snýkudýrið 	 sníkjudýrið
snytrir« 	 snytrir
söguþráði 	 söguþræði
solandrianaer 	 solandriana
sóleyjarætt 	 sóleyjaætt
sóleyjarætt 	 sóleyjaætt
sóleyjarætt 	 sóleyjaætt
sóleyjarætt 	 sóleyjaætt
sömur 	 sömu
sömu 	 sömur
sönn 	 sönn‘
sönn 	 sönn‘
sönn 	 sönn‘
son­ur 	 sonur
sorbitol 	 sorbitól
sósíademókrataflokkur 	 sósíademókrataflokkinn
sósíalistaflokkurinn» 	 sósíalistaflokkurinn
sósjalíska 	 sósíalíska
spaghetti 	 spaghetto
spaghettí 	 spaghetto
spaghetto 	 spaghetti
spaghetto 	 spaghettí
sparnaðahlutfall 	 sparnaðarhlutfall
spatthaltir 	 spatthelti
spatthelti 	 spatthaltir
sphila 	 spila
spila 	 sphila
spillefni 	 spilliefni
spillefni 	 spilliefni
spingur 	 springur
sporvagankerfið 	 sporvagnakerfi
sporvagnakerfi 	 sporvagankerfið
sprengivörpur 	 sprengjuvörpur
sprengugígur 	 sprengigígur
sprenigingu 	 sprengingu
spurningamerki 	 spurningarmerki
ssæstjörnur 	 sæstjörnur
ssæstjörnur 	 sæstjörnur
staðartölvunni 	 staðartölvu
staðreydnir 	 staðreyndir
staðseettur 	 staðsettur
staðsetningartalnakerfi 	 staðsetningatáknakerfi
staðsetningatalnakerfi 	 staðsetningatáknakerfi
stækkadi 	 stækkaði
stærðfræðiaðferð 	 stærðfræðiaðgerð
stærðfræðiaðferð 	 stærðfræðiaðgerð
stærðfræðiaðferð 	 stærðfræðiaðgerð
stærðfræðiferilinn 	 stærðfræðiferil
stærðfræðinar 	 stærðfræðinnar
stærðfræðinnar 	 stræðfræðinnar
stæsta 	 stærsta
stafróið 	 stafrófið
stafróinu 	 stafrófinu
sták 	 strák
starfad 	 starfað
starfnar 	 starfar
starfsækt 	 starfrækt
starsfemi 	 starfsemi
steindaldarhörpinni 	 steindaldarhörpunni
steingerfingi 	 steingervingi
sterkindahraðallinn 	 sterkeindahraðallinn
sterkstu 	 sterkustu
stéttarskipting 	 stéttskipting
stilklausog 	 stilklaus
stimlað 	 stimplað
stjarnarn 	 stjarnan
stjarnar 	 stjarna
stjarnar 	 stjarnan
stjónrmálum 	 stjórnmálum
stjónum 	 stjórnum
stjórmálaflokkur 	 stjórnmálaflokkur
stjórmálamaður 	 stjórnmálamaður
stjórnmálamaðir 	 stjórnmálamaður
stjórnmalamenn 	 stjórnmálamenn
stjórnmálananninum 	 stjórnmálamanninum
stjórnmálastofnanir 	 stjórnmálastofnanirnar
stjórnmiðstöð 	 stjórnstöð
stjórnmiðstöð 	 stjórnstöð
stjörnufræði 	 stjörnufræðinámi
stjornum 	 stjórnum
stj-rnunar 	 stjörnurnar
stj-rnunar 	 stjörnurnar
stoðdeild 	 stoðdeildir
stöðugru 	 stöðugu
stöðugust 	 stöðugusta
stofað 	 stofnað
stofnananda 	 stofnanda
stofnðu 	 stofnuð
stofnunin 	 stofnuninnar
stofuðu 	 stofnuðu
stólsing 	 stólsins
stonfaði 	 stofnaði
stonfuð 	 stofnuð
stonfuð 	 stofnuð
stonfuð 	 stofnuð
stórborgarsvæði 	 stórborgarsvæðið
stórbyli 	 stórbýli
stórhertogadæmi 	 stórhertogadæminu
storknaberg 	 storkuberg
storkubergfræði 	 storkubergsfræði
stórsæa 	 stórsæja
stórsæa 	 stórsæja
straum–laxinn 	 straumlaxinn
straunlínulagaðra 	 straumlínulagaðra
streyta 	 streita
streyta 	 streita
stríðana 	 stríðanna
stríðsmansins 	 stríðsmannsins
stríðsskaðabætna 	 stríðsskaðabóta
strjónað 	 stjórnað
strjónað 	 stjórnað
student 	 stúdent
stuðlaðj 	 stuðlað
stúlkunar 	 stúlkunnar
stúlkuni 	 stúlkunni
stuningsmeðferð 	 stuðningsmeðferð
styðtu 	 styðstu
styja 	 styðja
styjðja 	 styðja
stykt 	 styrkt
stýrimæður 	 stýrimaður
subreddits 	 subreddit
súcrósa 	 súkrósa
suðaustum 	 suðaustur
suð-suðvestur 	 suðsuðvestur
suðuraustri 	 suðaustri
suðvedurhluta 	 suðvesturhluta
suðvesturin 	 suðvestur
suðvesturin 	 suðvestur
súkkúlaðistykki 	 súkkulaðistykki
sumartíman 	 sumartímann
summt 	 sumt
sunnarverðan 	 sunnanverðan
sutján 	 sautján
svartann 	 svartan
svart-blár 	 svarblár
svart-blátt 	 svarblátt
svart-tungu 	 svarttungu
sveifjanleg 	 sveigjanleg
sveitafélag 	 sveitarfélag
sveitafélag 	 sveitarfélag
sveitarfélafinu 	 sveitarfélaginu
sveitastjórnarkosningum 	 sveitarstjórnarkosningunum
sveitastjórnarráðuneytið 	 sveitarstjórnarráðuneytið
sverðfiskategund 	 sverðfiskstegund
svingómýelín 	 sfingómýelín
svingómýelín 	 sfingómýelín
svipupum 	 svipuðum
svökölluðu 	 svokölluðu
svoköllumðum 	 svokölluðum
svóru 	 sóru
sýdar 	 sýndar
sykursameind 	 sykrusameind
sýndarraunveruleika 	 sýndarveruleika
sýndarraunveruleika 	 sýndarveruleika
sýndarveruleikin 	 sýndarveruleikinn
sýningarinna 	 sýningarinnar
systkinjapör 	 systkinapör
sytting 	 stytting
sytt 	 stytt
tadsjikíska 	 tadsikíska
tadsjikíska 	 tadsikíska
tadsjiskra 	 tadsjískra
tákanað 	 táknað
taknmálið 	 táknmálið
taldnar 	 taldar
taldnir 	 taldir
tánað 	 táknað
tankskibið 	 tankskipið
tannlœkni 	 tannlækni
tegjast 	 tengjast
tegnudir 	 tegundir
tegundi 	 tegundin
temruðum 	 tempruðum
tendur 	 stendur
tenglsa 	 tengsla
tenglsin 	 tengslin
tenglsum 	 tengslum
tengs 	 tengst
tengund 	 tegund
teplöntunar 	 teplöntunnar
tequilana 	 tequila
tertron 	 terton
tetrasyklín 	 tetrasýklín
tetrasyklín 	 tetrasýklín
tetroninn 	 tertoninn
textan 	 textann
tíbetönsku 	 tíbetsku
tíbetskir 	 tíbeskir
tíbetsk 	 tíbesks
tíbetskt 	 tíbetska
tíbetskum 	 tíbesku
tíbetskum 	 tíbeskum
tíbetsku 	 tíbesku
tíbetsku 	 tíbeskum
tíðgast 	 tíðkast
tíðkuðst 	 tíðkuðust
tíðkuðst 	 tíðkuðust
tiheyrðu 	 tilheyrðu
tilfiningum 	 tilfinningum
tilheira 	 tilheyra
tilheirir 	 tilheyrir
tilheyging 	 tilhneiging
tilheyraog 	 tilheyra
tiltörulega 	 tiltölulega
tiltörulega 	 tiltölulega
tímagreinda 	 tímagreindri
tímannn		tímann
tímaritiðið 	 tímaritið
tímaritiðið 	 tímaritið
tímarítinu 	 tímaritinu
timarit 	 tímarit
timímabilinu 	 tímabilinu
títan-díoxíð 	 títandíoxíð
tján 	 tjá
tján 	 tjákn
tjarnarstararinnar 	 tjarnastararinnar
töluer 	 tölur
tölvna 	 tölva
tölvutækninnanar 	 tölvutækninnar
tombónleikarinn 	 trombónleikari
tóniki 	 tónik
tónistarþættir 	 tónlistarþættir
tónlistastefna 	 tónlistarstefna
tónlistaverðlaun 	 tónlistarverðlaun
tónlistin 	 hústónlistin
tónlistinn 	 tónlistin
tónlíst 	 tónlist
tónlíst 	 tónlist
tpvo 	 tvo
tréið 	 tréð
tréin 	 trén
trjáhringjamynstrið 	 árhringjamynstrið
trjáhringjamynstrið 	 árhringjamynstrið
trjáum 	 trjám
tryggingarsvikum 	 tryggingasvikum
tungnumál 	 tungumál
tungumálfræðingar 	 tungumálafræðingar
tungumálinn 	 tungumálin
tungunar 	 tungunnar
tungun 	 tungunni
tvem 	 tveim
tvem 	 tveim
tvem 	 tveim
tvem 	 tveim
tvem 	 tveim
tvem 	 tveim
tvem 	 tveim
tvenndarleik 	 tvendarleik
tvent 	 tvennt
tvent 	 tvennt
tvíburaróður 	 tvíburabróður
tvitugur 	 tvítugur
tvíundartré 	 tvíundatré
ullarlokbuxum 	 ullarbuxum
umhveri 	 umhverfi
umluknar 	 umluktar
undanafarin 	 undanfarin
undann 	 undan
undanskyldu 	 undanskildu
understöðusteinum 	 undirstöðusteinum
undilagi 	 undirlagi
undirbúningu 	 undirbúningur
undirmállískur 	 undirmállýskur
unhverfi 	 umhverfi
unkringir 	 umkringir
unlinga-gamanmynd 	 unglingagamanmynd
upfinningu 	 uppfinningu
upfinningu 	 uppfinningu
uppbygginu 	 uppbyggingu
uppbyggs 	 uppbyggðs
uppgövanir 	 uppgötvanir
uppgripaheyskapir 	 uppgripaheyskapur
uppgufanarmálma 	 uppgufunarmálma
uppgvötaði 	 uppgötvaði
uppgvötvaðir 	 uppgötvaðir
uppgvötvaðir 	 uppgötvaðir
upplisingar 	 upplýsingar
upplisingar 	 upplýsingar
upplýsingafyritæki 	 upplýsingafyrirtæki
uppp 	 upp
upprunið 	 upprunnið
uprunalegri 	 upprunalegri
úrferðarfall 	 íferðarfall
úrlistaleik 	 úrlslitaleik
úrskurðaur 	 úrskurðaður
úrvaldeilinni 	 úrvalsdeildinni
útbreiðslusvæniu 	 útbreiðslusvæðinu
útbreislusvæði 	 útbreiðslusvæði
útbreyðslu 	 útbreiðslu
útekt 	 úttekt
útgáfufyrritæki 	 útgáfufyrirtæki
útgávum 	 útgáfum
úthugsaðari 	 úthugsaðri
útsendingsfyrirtæki 	 útsendingarfyrirtæki
útskrifaðst 	 útskrifaðist
útsláttakeppni 	 útsláttarkeppni
útvöxutrinn 	 útvöxturinn
uypplifa 	 upplifa
valoppandi 	 valhoppandi
vanalga 	 vanalega
varðveitngu 	 varðveitingu
varmaþennslu 	 varmaþenslu
varm 	 varma
vatnaskiljum 	 vatnaskilum
vatnsaflvirkjun 	 vatnsaflsvirkjun
vaxtarmunaviðskipti 	 vaxtarmunarviðskipti
veðurathugnartímum 	 veðurathugunartímum
veegar 	 vegar
vefhreifimynd 	 vefhreyfimynd
vefhreifimynd 	 vefhreyfimynd
vegalengt 	 vegalengd
veggsjpaldinu 	 veggspjaldinu
veggum 	 veggjum
veggum 	 veggjum
veggum 	 veggjum
veggum 	 veggjum
veggum 	 veggjum
veiðuna 	 veiðina
veitingarhús 	 veitingahús
velbúnað 	 vélbúnað
veldingu 	 veldinu
veraldarhyggja 	 veraldrarhyggja
veraldrahyggja 	 veraldarhyggja
veraldrahyggja 	 veraldrarhyggja
verðferðarkerfið 	 velferðarkerfið
verðlægi 	 verðlagi
verduð 	 vernduð
verkfræðinnnar 	 verkfræðinnar
verklög 	 verklag
verlaun 	 verðlaun
verlunarborg 	 verslunarborg
verndarsvæðunu 	 verndarsvæðunum
vernjulegar 	 venjulegar
verslunamiðstöðvar 	 verslunarmiðstöðvar
vesópressín 	 vasópressín
vestur-slavneskra 	 vesturslavneskra
veturnar 	 veturna
veturnar 	 veturna
veturnar 	 veturna
veturninn 	 veturinn
veturtinn 	 veturinn
vexx 	 vex
viðar-kassi 	 viðarkassi
viðar-kassi 	 viðarkassi
viðáttumiklir 	 víðáttumiklir
víðfemt 	 víðfeðm
víðlesnastu 	 víðlesnustu
viðsvegar 	 víðsvegar
vigurstæðr 	 vigurstærð
víkinga-þungarokkið 	 víkingaþungarokkið
víkinga-þungarokk 	 víkingaþungarokk
vindáttog 	 vindátt
vinnadýr 	 vinnudýr
vintra 	 vinstra
vinulágið 	 vinulágin
vinýlklóríðs 	 vínýlklóríðs
vinýlklóríðs 	 vínýlklóríðs
vísindagheimspeki 	 vísindaheimspeki
viskerfum 	 vistkerfum
vistarberum 	 vistarverum
vistkefði 	 vistkerfi
vítæku 	 víðtæku
vitha 	 vita
vituvefur 	 fituvefur
vopantækni 	 vopnatækni
vopninn 	 vopnin
voruá 	 voru
yðkaðar 	 iðkaðar
yffirráðasvæði 	 yfirráðasvæðin
yfileitt 	 yfirleitt
yfileitt 	 yfirleitt
yfileitt 	 yfirleitt
yfileitt 	 yfirleitt
yfirleit 	 yfirleitt
yfirráðun 	 yfirráð
yfirskrifar 	 yfirskrifast
ýmisa 	 ýmis
ýmissra 	 ýmissa
ýmisum 	 ýmsum
yngismans 	 yngismanns
zeta-fallsins 	 zetafallsins
zinkbsteinda 	 zinksteinda
þættinna 	 þættina
þanig 	 þannig
þanneig 	 þannig
þanning 	 þannig
þáttakendur 	 þátttakendur
þeagar 	 þegar
þeagar 	 þegar
þeekist 	 þekkist
þeira 	 þeirra
þekktasur 	 þekktastur
þektastir 	 þekktastir
þekttust 	 þekktust
þekttust 	 þekktust
þektur 	 þekktur
þekt 	 þekkt
þemótvægisaðgerðir 	 mótvægisaðgerðir
þemulagið 	 þemalagið
þem 	 þeim
þem 	 þeim
þeramínið 	 þeremínið
þeramínsins 	 þeremínsins
þessarra 	 þessara
þessumm 	 þessum
þesu 	 þessu
þettist 	 þéttist
þikkari 	 þykkari
þíþróttavelli 	 íþróttavelli
þjóðaframleiðsla 	 þjóðarframleiðsla
þjóðatungum 	 þjóðtungum
þjóðerninsímynd 	 þjóðernisímynd
þjóðískr 	 þjóðiskr
þjóðlaga-þungarokki 	 þjóðlagaþungarokki
þjóðsagnasafnar 	 þjóðsagnasafnari
þjónústu 	 þjónustu
þjónústu 	 þjónustu
þjórernisflokkunum 	 þjóðernisflokkunum
þrælahaldm 	 þrælahald
þrálaus 	 þráðlaust
þrangar 	 þröngar
þrepeimingu 	 þrepaeimingu
þrfnast 	 þarfnast
þrfnast 	 þarfnast
þrfnast 	 þarfnast
þrfnast 	 þarfnast
þríhirnda 	 þríhyrnda
þríhirnda 	 þríhyrnda
þríhirningum 	 þríhyrningum
þríhirningum 	 þríhyrningum
þríhyrnina 	 þríhyrninga
þríhyrnina 	 þríhyrninga
þrjatíu 	 þrjátíu
þróaist 	 þróaðist
þróðair 	 þróaðir
þrú 	 þrjú
þrýstingarmuni 	 þrýstingsmuni
þrysting 	 þrýsting
þungarokkshljósveit 	 þungarokkshljómsveit
þurkuðum 	 þurrkuðum
þurkuð 	 þurrkuð
þurrkt 	 þurrt
þur 	 þurr
þúsundra 	 þúsunda
þyngdarfasti 	 þyngdarfastinn
þyrniættkvísl 	 þyrnaættkvísl
þýttbýlissvæði 	 þéttbýlissvæði
