óreirðum 	 óeirðum
akit 	 kit
svFaisal 	 Faisal
Dravídamál 	 dravídamál
Kúsískt 	 kúsískt
Hippias 	 Hippías
samóíska 	 samóska
Hogwarts 	 Hogwart
Nepölsku 	 nepölsku
kisabækur 	 Kisabækur
Micheal 	 Michael
veturnar 	 veturna
Úggasyni 	 Uggasyni
Mandarín 	 mandarín
tannlœkni 	 tannlækni
deyji 	 deyi
Planta 	 Plantan
Annaðhvort 	 annaðhvort
Skólinnm 	 Skólinn
York-fylkis 	 York-fylki
Celsíuskvarðanum 	 Selsíuskvarðanum
Kyle 	 Kylie
sparrhaukur 	 Sparrhaukur
Staðalráð 	 Staðlaráð
miðjann 	 miðjan
miðjann 	 miðjan
Finnsku 	 finnsku
Þjóðsöngsins 	 þjóðsöngsins
Ástrónesískt 	 ástrónesískt
mjaldi 	 mjaldri
Berghlaupð 	 Berghlaup
flóaskel 	 flóaskelin
flóaskel 	 flóaskelin
álaggirnar 	 laggirnar
æskuærin 	 æskuárin
LImbaugh 	 Limbaugh
Samískan 	 Samísk
fjölbreytt 	 fjölbreyt
Ástrónesíkt 	 ástrónesískt
Pompei 	 Pompeii
Hæstráðandi 	 hæstráðandi
Hæstráðandi 	 hæstráðandi
Þesi 	 Þessi
Anton 	 Antoon
Þjóðsöngur 	 þjóðsöngur
töluer 	 tölur
Eyjolfur 	 Eyjólfur
Glittertinden 	 Glittertind
færeyja 	 Færeyja
Samnefndt 	 Samnefnt
gefinu 	 gefin
Auðunnarmáldaga 	 Auðunarmáldaga
AB-mjólk 	 Ab-mjólk
Augun 	 Augu
algegnust 	 algengust
Kolsveins 	 Kollsveins
Hómelíubók 	 Hómilíubók
fersentimetra 	 fersentímetra
Kampsránið 	 Kambsránið
stórbyli 	 stórbýli
SVíþjóð 	 Svíþjóð
skógarreitir 	 skógarreiti
Cheshires 	 Cheshire
aðtæður 	 aðstæður
Feidías 	 Fidías
Hrygningin 	 Hrygning
Hardford 	 Hartford
Hausman 	 Hausmann
eingin 	 engin
Árrósum 	 Árósum
þeekist 	 þekkist
O´Donnell 	 ODonnell
Asískar 	 asískar
Ferðaþjónusta 	 ferðaþjónusta
eftirAbdullah 	 eftirAbdúlla
desmeber 	 desember
desmeber 	 desember
Winnipegvatnið 	 Winnipegvatn
Hómelíubók 	 Hómilíubók
Kristijaníu 	 Kristjaníu
tegundin 	 Tegundin
Þjóðsöngur 	 þjóðsöngur
suður-Kyrrahafi 	 Suður-Kyrrahafi
fyrirAbdullah 	 fyrirAbdúlla
Iyotake 	 Íyotake
Jangstefljót 	 Jangtsefljót
algegnt 	 algengt
Ólympusfjall 	 Ólympsfjall
Járninnihaldið 	 Járninnihald
ælmihtiga 	 Ælmihtiga
Flöskvatn 	 Flöskuvatn
núverandi 	 Núverandi
Flöskvatn 	 Flöskuvatn
núverandi 	 Núverandi
kúbumeistarann 	 Kúbumeistarann
löggðu 	 lögðu
enChurch 	 Church
Episódios 	 episódios
Episódios 	 episódios
Episódios 	 episódios
Episódios 	 episódios
viðDartmouth 	 Dartmouth
algenasta 	 algengasta
Slóvenska 	 slóvenska
Afrísku 	 afrísku
savönuni 	 savönnuni
Viðauki 	 viðauki
Indonesíu 	 Indónesíu
Chronika 	 Chronica
Hogwarts 	 Hogwart
loftfyrrtum 	 loftfirrtum
college 	 College
gardens 	 Gardens
Akershus 	 Akershús
Reykjavíur 	 Reykjavíkur
Þessi 	 Þessir
Nýjir 	 Nýir
Mjólkurafurðir 	 Mjólkurafurð
myndsögublöðum 	 myndasögublöðum
Austubæjarbíói 	 Austurbæjarbíói
Eggert 	 ├─Eggert
Hitchcok 	 Hitchcock
Claudius 	 Claudíus
stonfuð 	 stofnuð
þjónústu 	 þjónustu
stonfuð 	 stofnuð
þjónústu 	 þjónustu
hérðassambandi 	 héraðssambandi
Fernandez 	 Fernández
Medellin 	 Medellín
Karlsaon 	 Karlsson
taugafrumur 	 Taugafrumur
Trinidad 	 Trínidad
þektur 	 þekktur
afSichuanhéraði 	 Sichuanhéraði
Landsbókarsafni 	 Landsbókasafni
Suðuroy 	 Suðurey
rófunnar 	 rófunar
Basil 	 Basils
taldnir 	 taldir
Edison 	 Edson
KópaBabana 	 KópaCabana
Skógrækt 	 Skógræktin
Einkennist 	 einkennist
ranskaður 	 ransakaður
Hnúðinn 	 Hnúðurinn
Sveitarfélag 	 sveitarfélag
Melville 	 Melvil
Melvil 	 Melville
opinpert 	 opinbert
Norrænni 	 norrænni
Edvaldsen 	 Edvardsen
misævis 	 miðsævis
Íslensk 	 íslensk
Felmstursköst 	 Felmtursköst
Frakkaland 	 Frakkland
Felmstursköst 	 Felmtursköst
Frakkaland 	 Frakkland
Dravídamál 	 dravídamál
Hörðaknútur 	 Hörða-Knútur
Fjóní 	 Fjón
þanning 	 þannig
þættinna 	 þættina
mónasítssandi 	 mónasítsandi
Mílanó 	 Mílan
Etrúría 	 Etrúra
teikning 	 Teikning
Julíusar 	 Júlíusar
teikning 	 Teikning
Julíusar 	 Júlíusar
Mjólkurhvítt 	 mjólkurhvítt
Skrifuð 	 skrifuð
Yale-háskólann 	 Yale-háskóla
skiftir 	 skiptir
þrívíddarmynd 	 Þrívíddarmynd
metýlínbláu 	 metýlenbláu
Sveitarfélag 	 sveitarfélag
Suðvestur 	 suðvestur
Fifty-One´´ 	 Fifty-One
Þjóðleg 	 þjóðleg
tengs 	 tengst
Taxifolin 	 taxifolin
tuttugusti 	 tuttugusta
Hugmyndir 	 Hugmyndirnar
Stundaði 	 stundaði
Runnan 	 Runnann
Bréf 	 Bréfa
jurtæta 	 jurtaæta
jurtæta 	 jurtaæta
Kolsveinn 	 Kollsveinn
Johseph 	 Joseph
Einginn 	 Enginn
grafarkirkja 	 graftarkirkja
súkkúlaðistykki 	 súkkulaðistykki
sjórn 	 stjórn
NA-Dene 	 Na-Dene
Riddara 	 Riddarar
rebaudina 	 rebaudiana
Stiklastaðaorusta 	 Stiklastaðaorrusta
tombónleikarinn 	 trombónleikari
Hrygnir 	 hrygnir
Uzbekistan 	 Uzbekistansvg
lögsögumaður 	 lögumaður
bandaríks 	 bandarísk
meðallegnd 	 meðallengd
Landlunkt 	 Landlukt
Malavíska 	 malavíska
ofsarlega 	 ofsalega
Grafarhýsi 	 Grafhýsi
Ritvél 	 Ritvélin
Skeiða 	 Skeiða-
Gnúpsverjahreppi 	 Gnúpverjahreppi
Enska 	 Ensk
Míletós 	 Míletos
Aaage 	 Aage
bantúmálinu 	 bantúmálsins
Giftist 	 giftist
Estelle 	 Estella
Estelle 	 Estella
ark 	 Park
Aðalvikur 	 Aðalvíkur
Aðalvikur 	 Aðalvíkur
jötunheimi 	 Jötunheimi
deUniversity 	 University
deUniversity 	 University
fjórð 	 fjórða
rababara 	 rabarbara
rökkursdýra 	 rökkurdýra
austurkarabískur 	 austkarabískur
Vinsælastast 	 Vinsælast
stafkirkja 	 Stafkirkjan
páfiTelefórus 	 páfiTelesfórus
Kingveldinu 	 Tjingveldinu
Þoleifur 	 Þorleifur
flyswatter 	 Flyswatter
Djúnka 	 júnka
júnka 	 Djúnka
íslenskt 	 Íslenskt
Sveitabær 	 sveitabær
degið 	 dregið
undanafarin 	 undanfarin
iðnaðar 	 iðnaðar-
verlunarborg 	 verslunarborg
Kremlið 	 Kremlin
Guðsins 	 guðsins
Nestorius 	 Nestoríus
veturnar 	 veturna
Orrustunni 	 orrustunni
Piparminta 	 Piparmynta
Persefnóu 	 Persefónu
Stundaði 	 stundaði
hövuðstaður 	 höfuðstaður
ásiáttur 	 ásláttur
Varð 	 Var
Borgin 	 Borgina
stjórnmalamenn 	 stjórnmálamenn
Aserbaídsjani 	 Aserbaídsjan
Pavlov 	 Pavlovs
DNAið 	 DNA-ið
kalíumsalta 	 kalsíumsalta
pleósentímabilinu 	 pleiósentímabilinu
hentungur 	 hentugur
NesklúbburinnNK 	 Nesklúbburinn
Parastui 	 Parastouei
Parastouei 	 Parastui
rigning 	 Rigning
Turkmenistan 	 Turkmenistansvg
mydön 	 myndön
japöns 	 japönsk
Eton-háskóla 	 Eton-skóla
Kastalinn 	 kastalinn
Femer 	 Femern
Edouard 	 Édouard
Fransiskana 	 fransiskana
Leysist 	 leysist
helmingur 	 Helmingur
Dvergmörgæs 	 dvergmörgæs
Indirðason 	 Indriðason
Almenningssalerni 	 almenningssalerni
fjarskild 	 fjarskyld
Andasúsíu 	 Andalúsíu
Slímkolans 	 slímkolans
höfuðdugðinni 	 höfuðdygðinni
Svifryk 	 svifryk
Skandenavískum 	 skandinavískum
Íslensku 	 íslensku
ger-sveppi 	 gersveppi
rauðumn 	 rauðum
Bergbráð 	 bergbráð
Brönugrasins 	 Brönugrassins
Manndómsvígla 	 Manndómsvígsla
Østfold-fylki 	 Austfold-fylki
Þessa 	 Þess
Manndómsvígla 	 Manndómsvígsla
Østfold-fylki 	 Austfold-fylki
Þessa 	 Þess
hræum 	 hræjum
Flavíus 	 Flavius
Valeríus 	 Valerius
rjóma-gulur 	 rjómagulur
hópuust 	 hópuðust
Miljónafélagið 	 Milljónarfélagið
herin 	 herinn
origani 	 origami
Orustan 	 Orrustan
enskumælandi 	 ensku-mælandi
Vologodafylki 	 Vologdafylki
ngilsaxneska 	 Engilsaxneska
sérsakt 	 sérstakt
Stundaði 	 stundaði
lokaáhlaup 	 lokaáhlaupi
aukafollunum 	 aukaföllunum
núningseldspýta 	 núningseldspýtan
vigfússon 	 Vigfússon
vigfússon 	 Vigfússon
gígarraðirnar 	 gígaraðirnar
Lakasvæði 	 Lakasvæðinu
liðskiftir 	 liðskiptir
Gujarat 	 Gújarat
útskrifaðst 	 útskrifaðist
breiðskifa 	 breiðskífa
Stærsta 	 stærsta
kilógram 	 kílógram
postulasögunni 	 Postulasögunni
Sandorma 	 Sandorms
selabaggi 	 Selabaggi
stundum 	 Stundum
Tilheyrir 	 tilheyrir
Altajískra 	 altajískra
Afghanistan 	 Afghanistansvg
Aszuradeh 	 Ashuradeh
Bjarnarneshreppi 	 Bjarnaneshreppi
Eignafall 	 Eignarfall
Íslensku 	 íslensku
Eiðsifjaþing 	 Eiðsifaþing
Hvammssfirði 	 Hvammsfirði
Hvammssfirði 	 Hvammsfirði
lögsagnarumbæmi 	 lögsagnarumæmi
VIII 	 III
III 	 VIII
útekt 	 úttekt
færeyja 	 Færeyja
heimaríknir 	 heimaríkir
Kyrgyzstan 	 Kyrgyzstansvg
Leibiz 	 Leibniz
hanns 	 hans
Pressan 	 Pressanis
Pófunarskýrsla 	 Prófunarskýrsla
þingbundina 	 þingbundna
Sriðsund 	 Skriðsund
íGrasagarði 	 Grasagarði
Ihna 	 Ina
tertron 	 terton
eiðisvegur 	 Eiðisvegur
Héraðsdómuir 	 Héraðsdómur
Vestmanneyjum 	 Vestmannaeyjum
gosubergi 	 gosbergi
Íverfall 	 Íverufall
einnkaþjónn 	 einkaþjónn
Franzl 	 Franz
Franz 	 Franzl
Franzl 	 Franz
Franz 	 Franzl
Christoph 	 Christopher
Diederich 	 Diderich
orkuuppspretta 	 orkuuppsprettu
Veiðist 	 veiðist
asperíni 	 aspiríni
Peringskjöld 	 Peringskiöld
Peringskiöld 	 Peringskjöld
jarðabók 	 Jarðabók
Rússneska 	 rússneska
Víetnömsku 	 víetnömsku
skyldleykalaust 	 skyldleikalaust
Neanderdalsmenn 	 neanderdalsmenn
portúgala 	 Portúgala
Litlaust 	 litlaust
Qalqilyah 	 Qalqilya
Meðalstraumur 	 Meðalrafstraumur
Rastafari 	 rastafari
Helsingborg 	 Helsingjaborg
náqrannabæjir 	 nágrannabæir
Þeófrastosat 	 Þeófrastosar
aðalherbergi 	 baðherbergi
vefnaður 	 Vefnaður
tvem 	 tveim
aðlalsalurinn 	 aðalsalurinn
bakkalárshgráðu 	 bakkalársgráðu
flutninsmáti 	 flutningsmáti
Fingurhlífar 	 fingurhlífar
Hæðsti 	 Hæsti
Mið-Afríkulýðveldisinss 	 Mið-Afríkulýðveldisins
Fingurhlífar 	 fingurhlífar
Hæðsti 	 Hæsti
Mið-Afríkulýðveldisinss 	 Mið-Afríkulýðveldisins
gjaldmiðl 	 gjaldmiðils
gjaldmiðl 	 gjaldmiðli
aðgægjast 	 gægjast
Bárðadal 	 Bárðardal
Ávextir 	 ávextir
plöntur 	 Plöntur
hryggleysingum 	 hryggleysingjum
veiru 	 veiru-
hængarnir 	 Hængarnir
gamlinr 	 gamlir
sagð 	 sagði
Bereley 	 Berkeley
Kísilsteind 	 kísilsteind
Lífdísilolía 	 Lífdísill
lífeldnseyti 	 lífeldsneyti
hægrissinnaður 	 hægrisinnaður
Rangeyni 	 Rangeygni
Staint 	 Saint
Sakynhneigðir 	 Samkynhneigðir
Söngvakeppni 	 söngvakeppni
tvem 	 tveim
Myndast 	 myndast
Rómavedis 	 Rómaveldis
dökkbláann 	 dökkbláan
Útvarpsperlu 	 Útvarpsperlur
StGallen 	 Gallen
mannarfbótasinna 	 arfbótasinna
Knattspyrnulið 	 knattspyrnulið
Norð-vestur 	 norðvestur
Eyðibýli 	 eyðibýli
öxnadal 	 Öxnadal
Asískra 	 asískra
Hurðarvængirnar 	 Hurðarvængirnir
dreyfða 	 dreifða
Hurðarvængirnar 	 Hurðarvængirnir
dreyfða 	 dreifða
Gresjufílarnir 	 gresjufílarnir
Afríski 	 afríski
Hljómplata 	 Hljómplatan
Absolon 	 Absalon
Aðalnámskrá 	 aðalnámskrá
jurtunni 	 jurtinni
Nu-metali 	 nu-metali
accipiter 	 Accipiter
Íslandi 	 Islandi
tíbetskt 	 tíbetska
Kárhnjúkar 	 Kárahnjúkar
lceland 	 Iceland
Grafninghreppur 	 Grafningshreppur
safnaðarinns 	 safnaðarins
Kristalar 	 Kristallar
djass-rokk 	 djassrokk
þessumm 	 þessum
Manngervður 	 Manngerður
Einangrun 	 einangrun
íslenska 	 íslenzka
Teljalegt 	 Teljanlegt
Einig 	 Einnig
þjóðsagnasafnar 	 þjóðsagnasafnari
Philippines 	 Philippinessvg
Philippines 	 Philippinessvg
fæddisst 	 fæddist
Hamlet 	 Hamlets
Kárahnjúkastífa 	 Kárahnjúkastífla
McCains 	 McCain
jafnátt 	 jafnátta
Britpop 	 Britpopp
Word 	 World
þróðair 	 þróaðir
Uphafsmaður 	 Upphafsmaður
Páfugl 	 Páfuglar
Inriðasonar 	 Indriðasonar
krats 	 krafts
Magnús 	 ├─Magnús
Emilía-Rómanjai 	 Emilía-Rómanja
tjarnarstararinnar 	 tjarnastararinnar
Kingveldið 	 Tjingveldið
tvíundartré 	 tvíundatré
Tímanns 	 Tímans
taldnar 	 taldar
Byggðasafn 	 byggðasafn
aðallega 	 aðalega
Grasaætt 	 grasaætt
dúfnabaun 	 dúfnabaunir
hæðstakaupstað 	 Hæstakaupstað
Unifacation 	 Unification
Unifacation 	 Unification
norðasutur 	 norðaustur
stjónum 	 stjórnum
Bleiklax 	 bleiklax
Microsoft-útgáfan 	 Microsoft-útgáfa
All’s 	 Alls
coronaveirur 	 picornaveirur
Mismunandi 	 mismunandi
mismunandi 	 Mismunandi
austurströnd 	 mið-austurströnd
Sigmúnds 	 Sigmunds
dundurspillir 	 tundurspillir
Palearktíska 	 palearktíska
bretlandi 	 Bretlandi
Svöldarbardagi 	 Svoldarbardagi
Sið-harðkjarni 	 Síð-harðkjarni
Íslenska 	 Íslenzka
Íþróttafélag 	 íþróttafélag
Leikfélag 	 leikfélag
lifrustig 	 lirfustig
myndinn 	 myndin
fljölga 	 fjölga
Eldlandi 	 Eldlandinu
Magellansund 	 Magellansundi
Falun 	 Falu
Falun 	 Falu
núerandi 	 núverandi
núerandi 	 núverandi
Xinu 	 X-inu
Ijsselmeer 	 IJsselmeer
tenglsa 	 tengsla
kvikmynda-iðnaðinum 	 kvikmyndaiðnaðinum
einfadlega 	 einfaldlega
suðvestur-Ontaríó-fylkis 	 suðvestur-Ontaríó-fylki
Sæmndar 	 Sæmundar
Risotto-grjónin 	 Risottogrjónin
Arborio 	 arborio
Þúkýdídes�ar 	 Þúkýdídesar
subreddits 	 subreddit
háskóla 	 Háskóla
Reallity 	 Reality
sabbath 	 Sabbath
suður-Wales 	 Suður-Wales
Tempraða 	 Temprað
víkinga-þungarokkið 	 víkingaþungarokkið
popp-hljómsveit 	 popphljómsveit
bæjir 	 bæir
Amerískum 	 amerískum
atburðaminni 	 Atburðaminni
Sölmundarsons 	 Sölmundarsonar
Claudius 	 Claudíus
stonfuð 	 stofnuð
innn 	 inn
Latnesku 	 latnesku
Bandarísk 	 bandarísk
lHôpital 	 Hôpital
Fjölskylda 	 fjölskylda
afhvæmi 	 afkvæmi
Simpsson 	 Simpson
daUniversity 	 University
lagvopn 	 Lagvopn
Bandarískur 	 bandarískur
Paracetamól 	 Parasetamól
fæddurb 	 fæddur
Myndrétthafa 	 myndrétthafa
kaffíns 	 koffíns
Sterkar 	 sterkar
íþróttafélagið 	 Íþróttafélagið
sovjétríkjanna 	 Sovjétríkjanna
Embættispróf 	 embættispróf
Vantrúar 	 Vantrú
Perso-Arabísku 	 perso-arabísku
Perso-Arabísku 	 perso-arabísku
Menntaskólans 	 Menntaskólanum
Bandarísk 	 bandarísk
Jómfrúreyjar 	 Jómfrúaeyjar
Bóking 	 Bókin
Híeróglýfur 	 híeróglýfur
undirmállískur 	 undirmállýskur
mozarella 	 mozzarella
Beiteins 	 Beinteins‎
hverfahluti 	 hverfishluti
drungarokkshljómsveit 	 þungarokkshljómsveit
Stúdent 	 stúdent
austur-karabískur 	 austurkarabískur
gekkk 	 gekk
Geymlsumiðill 	 Geymslumiðill
meðfera 	 meðferða
hugprúðír 	 hugprúðir
Eldfjallafrædi 	 Eldfjallafræði
mikklir 	 miklir
íslenska 	 íslenzka
markasetti 	 markaðssetti
Jósefus 	 Jósefos
Jósefus 	 Jósefos
Flavíus 	 Flavíos
Jósefus 	 Jósefos
Jósefus 	 Jósefos
kílómeter 	 kílómetri
Ágústusar 	 Ágústulusar
útvarpsstöðvar 	 útvarpstöðar
fylkini 	 fylkinu
landshlutinum 	 landshlutanum
fyrrverandi 	 Fyrrverandi
Charlie´s 	 Charlies
Grásadalsgöngin 	 Gásadalsgöngin
Turkmenistan 	 Turkmenistansvg
merkingar 	 Merkingar
mansjúríubjörk 	 Mansjúríubjörk
JPEG 	 JPG
Þrefaldur 	 þrefaldur
farsællasti 	 farsælasta
breiting 	 breyting
farsællasti 	 farsælasta
breiting 	 breyting
stykkishólmi 	 Stykkishólmi
Arabíska 	 arabíska
algent 	 algengt
Cassidy-Benedonfædd 	 Cassidy-Benedon
Hiranos 	 Hirano
Hirano 	 Hiranos
Myndast 	 myndast
hlýlju 	 hlýju
járnsegulmögnuðu 	 járnsegulmögnuðum
bleksíláti 	 blekíláti
Grenadíneyja 	 Grenadína
Norður-Dakota 	 Norður-Dakóta
svínasúpan 	 Svínasúpan
voruá 	 voru
Þeramín 	 Þeremín
svíþjóðar 	 Svíþjóðar
Höfuðborgin 	 Höfuðborg
ölpunum 	 Ölpunum
baju-refillinn 	 bæjö-refillinn
‘apud 	 apud
belnam’ 	 belnam
Byggingafræðinga 	 byggingafræðinga
efra-Breiðholti 	 Efra-Breiðholti
Fjölbrautarskólinn 	 Fjölbrautaskólinn
áttflötungar 	 áttflötunga
frumindoevrópsku 	 frumindóevrópsku
Fjölbrautarskólinn 	 Fjölbrautaskólinn
áttflötungar 	 áttflötunga
frumindoevrópsku 	 frumindóevrópsku
Grameðla 	 Grameðlan
Buskerydfylki 	 Buskerudfylki
Nassau-Siegen 	 Nassá-Siegen
deUniversity 	 University
atlandshafslaxar 	 atlantshafslaxar
Victoria 	 Victoriu
Messíasar 	 messíasar
Argentinu 	 Argentínu
Asískra 	 asískra
grasætt 	 grasaætt
díselolíu 	 dísilolíu
Míanmar 	 Mjanmar
Seljabúskapur 	 seljabúskapur
Selevkosi 	 Selevkos
leisstýrð 	 leikstýrð
Indriðason 	 Indriðasson
neysla 	 Ofneysla
hleyt 	 hleypt
Gagntækt 	 Gagntæk
bæðin 	 bæði
átækt 	 átæk
Gagntækt 	 Gagntæk
bæðin 	 bæði
átækt 	 átæk
arkitektúrina 	 arkitektúrinn
Tsjernobyl 	 Tjernobyl
kjarnorkuslys 	 Kjarnorkuslysið
Paleósen 	 paleósen
gróðurhúsaloftegund 	 gróðurhúsalofttegund
bandríkjunum 	 Bandríkjunum
Víðiætt 	 víðiætt
hitastiginn 	 hitastigið
JÓhannsson 	 Jóhannsson
gul-gylltar 	 gul-gyllt
Nokkrar 	 Nokkrir
suðurhlutinn 	 Suðurhlutinn
O´Donnell 	 ODonnell
O´Donnell 	 ODonnell
O´Donnell 	 ODonnell
O´Donnell 	 ODonnell
Geimskutluáætlunin 	 Geimskutluáætluninni
íslenska 	 íslenzka
gegnheld 	 gegnheil
Úralfljót 	 Úralfljóts
Kímmería 	 Kimmería
Sigmundsson 	 Sigmundarsson
Majorca 	 Majorka
skógarlaust 	 skóglaust
hljómasveit 	 hljómsveit
Columbia-háskólann 	 Columbia-háskóla
verkfræðinnnar 	 verkfræðinnar
Útskrifaðist 	 útskrifaðist
Oxford-háskólinn 	 Oxford-háskólans
grugggrunge-hljómsveit 	 grunge-hljómsveit
ikonpngHringur 	 iconpngHringur
Styttubönd 	 Styttuband
Þessarhreppsnefndarkosningar 	 hreppsnefndarkosningar
Tagalog 	 tagalog
Tjúktum 	 tjúktum
rómverksum 	 rómverskum
miðvesturströnd 	 miðvesturströndinni
flekaskil 	 Flekaskil
flekaskil 	 Flekaskil
stöðugust 	 stöðugusta
Sigvatn 	 sigvatn
járnsmiðir 	 Járnsmiðir
Jósefus 	 Jósefos
minst 	 minnst
Aðferðin 	 ðferðin
rakarafrumvarpið 	 rakarafrumvarpinu
Aðaldriffjöður 	 aðaldriffjöður
Nassauættinni 	 Nassáættinni
Arceface 	 Arseface
Zaraþústratrúarinna 	 Zaraþústrutrúarinnar
rokkarisveit 	 rokksveit
Bygging 	 Byggingin
O´Donnell 	 ODonnell
O´Donnell 	 ODonnell
O´Donnell 	 ODonnell
O´Donnell 	 ODonnell
Einstæðar 	 einstæðar
andstætt 	 Andstætt
hjómsveitin 	 hljómsveitin
brýþonska 	 brýþonsku
Þjóðirnar 	 þjóðirnar
brýþonska 	 brýþonsku
Þjóðirnar 	 þjóðirnar
Norðurárdal 	 Norðurárdalí
rómverksum 	 rómverskum
núllbaugi 	 núllbaug
Norð-Ameríku 	 Norður-Ameríku
hrikalaga 	 hrikalega
Lífdísill 	 Lífdísil
ferhyrntar 	 ferhyrndar
lífsseigt 	 lífseigt
Forráðakoan 	 Forráðakona
Hogwarts 	 Hogwart
Evrynome 	 Evrýnome
Algengusta 	 Algengasta
erfðavejur 	 erfðavenjur
þjónustuhugtökunum 	 þjónustuhugtök
Munchen 	 München
Munchen 	 München
ýmissra 	 ýmissa
Oddnýu 	 Oddnýju
eyjólfsdóttir 	 Eyjólfsdóttir
ingimars 	 Ingimars
Jarðsveppur 	 Jarðkeppur
fullnægingu 	 Fullnæging
Kodiakeyja 	 Kódiak-eyja
persnensku 	 persnesku
احمدی‌نژادf 	 احمدی‌نژاد
aðgreina 	 Aðgreina
hestamannafélagsins 	 Hestamannafélagsins
Seychelleseyjar 	 Seychelleyjar
fjársjóðurinn 	 Fjársjóðurinn
Ferhyrningur 	 ferhyrningur
hampshire 	 Hampshire
Bandaríska 	 bandaríska
Tónlist 	 Tónlistin
Abujmaria 	 abujmaria
amfíbólflokknum 	 amfibólflokknum
Akhetaten 	 Aketaten
Birg­ir 	 Birgir
Reykja­vík 	 Reykjavík
kenn­ara­prófi 	 kennaraprófi
Clara-sýsla 	 Clara-sýslu
Durlsey 	 Dursley
alríkisfulltrúann 	 FBI-alríkisfulltrúann
Ebro-fljót 	 Ebró-fljót
Gistiheimili 	 gistiheimili
fjölkvæmnisfugl 	 fjölkvænisfugl
Norrænni 	 norrænni
Norrænni 	 norrænni
Teiknimyndapersóna 	 teiknimyndapersóna
hræbjöllur 	 Hræbjöllur
presley 	 Presley
Byrjaði 	 byrjaði
íslendkar 	 íslenskar
leikastýra 	 leikstýra
Giftist 	 giftist
Vísindaheimspekinnar 	 vísindaheimspekinnar
snjóþungt 	 snjóþúngt
borgaravitundinni 	 borgaravitund
Sagnorð 	 Slagorð
eyjuþyrpingu 	 eyjaþyrpingu
þjóðanna 	 Þjóðanna
Weierstrass 	 Weierstraß
Weierstraß 	 Weierstrass
gjörvalt 	 gjörvallt
meiginladið 	 meginlandið
kýrillísku 	 kýrillíska
Antonia 	 Antonía
Johanna 	 Jóhanna
smásæar 	 smásæjar
Tímarit 	 tímarit
timarit 	 tímarit
Sister 	 Sisters
Sjónvarpstöðinni 	 sjónvarpsstöðinni
Haustið 	 haustið
innihöld 	 innihald
Coa 	 Coat
Hraunsásí 	 Hraunsási
handrítið 	 handritið
Gyðingdómi 	 gyðingdómi
Tanganyikavatn 	 Tanganjikavatn
Knattspyrnufélag 	 knattspyrnufélag
Íslenskra 	 íslenskra
Helenus 	 Helenos
litirnir 	 Litirnir
Íslenskra 	 íslenskra
Helenus 	 Helenos
litirnir 	 Litirnir
gauksætt 	 gaukaætt
Gereyðingarmálið 	 gereyðingarmálið
ferðabók 	 Ferðabók
rúnugaldri 	 rúnagaldri
huðláts 	 húðláts
Eulers 	 Euler
Euler 	 Eulers
—Jerry 	 Jerry
Aragóníu 	 Aragón
Spænska 	 spænska
Aragón 	 Aragóníu
Gyðingum 	 gyðingum
Heródótus 	 Heródótos
Lyngætt 	 lyngætt
That´s 	 Thats
flótt 	 fljótt
Íslenskur 	 íslenskur
Búðardad 	 Búðardal
Bæjarstjóri 	 bæjarstjóri
bæjarstjóri 	 Bæjarstjóri
heimstyrjöldinni 	 heimsstyrjöldinni
stundum 	 Stundum
kóriander 	 kóríander
Þessarhreppsnefndarkosningar 	 hreppsnefndarkosningar
lífræðigreinina 	 líffræðigreinina
Silfurlitaður 	 silfurlitaður
Urtendur 	 urtendur
Hagnýtri 	 hagnýtri
Dansaðu 	 dansaðu
dansaðu 	 Dansaðu
Þeramín 	 Þeremín
Austkarabíska 	 Austurkarabíska
gjalmiðilssamstarfið 	 gjaldmiðilssamstarfið
Gilbertseyjum 	 Gilbertseyja
JoeRetaliation 	 Retaliation
JoeRetaliation 	 Retaliation
Georg 	 George
George 	 Georg
eutektisk 	 eutektísk
Metallicu 	 Metallica
Lambdafllið 	 Lambdafallið
Zetufall 	 Zetufalli
Nígerískur 	 nígerískur
Menning 	 menning
Íslenska 	 íslenska
neðalstór 	 meðalstór
rómaríkis 	 Rómaríkis
undirstöðuréttur 	 undirstöðurþáttur
foreldar 	 foreldra
mjö 	 mjög
blóþrýstingsfall 	 blóðþrýstingsfall
Mynztur 	 Mynstur
færeyinga 	 Færeyinga
Leikmynda- 	 leikmynda-
tetrasyklín 	 tetrasýklín
færeyinga 	 Færeyinga
Leikmynda- 	 leikmynda-
tetrasyklín 	 tetrasýklín
höfuðborgarsvæði 	 Höfuðborgarsvæði
Framleidd 	 framleidd
Haway-eyjaklasanum 	 Hawaii-eyjaklasanum
Höfnt 	 Höfn
MelasveitÞar 	 Melasveit
—Bruckheimer 	 Bruckheimer
Kjúklingabaun 	 Kjúklingabaunin
tölvutækninnanar 	 tölvutækninnar
Íljitsj 	 Iljitsj
Pegasus 	 Pegasos
Metýlínblátt 	 Metýlenblátt
Saxaröld 	 Saxaöld
mongóla 	 Mongóla
smáyddur 	 smáyddir
Kristen 	 Kristin
Suður-Þingeyjasýslu 	 Suður-Þingeyjarsýslu
Íslensk 	 íslensk
Rómverskri 	 rómverskri
Thyraf 	 Thyra
Ólympsfjall 	 Ólympusfjall
Ólympusfjall 	 Ólympsfjall
Samtökin 	 samtökin
Aðstoðarmaður 	 aðstoðarmaður
fjöðum 	 fjöðrum
pínulittlar 	 pínulitlar
þríhirnda 	 þríhyrnda
bláann 	 bláan
pínulittlar 	 pínulitlar
þríhirnda 	 þríhyrnda
bláann 	 bláan
einkenni 	 Einkenni
skalotlauki 	 skalottlauk
Suður-Þingeyjasýslu 	 Suður-Þingeyjarsýslu
Konstantin 	 Konstantín
Rússneska 	 rússneska
minimax 	 Minimax
fátæktamat 	 fátæktarmatur
Venjulegar 	 Venjulega
heimstyrjöld 	 heimstyrjöldinni
Piparminta 	 Piparmynta
salgæti 	 sælgæti
Sláturfélag 	 sláturfélag
sláturfélag 	 Sláturfélag
silicon 	 Silicon
Vaasa 	 Vasa
Vasa 	 Vaasa
Cao 	 Caos
Caos 	 Cao
Flensborgarskóla 	 Flensborgarskólanum
míxtúra 	 míxtúru
Dulkornótt 	 dulkornótt
Amelíuborg 	 Amalíuborg
Meginhluta 	 Meginhluti
storknaberg 	 storkuberg
stríðsmansins 	 stríðsmannsins
control 	 Control
productions 	 Productions
tvitugur 	 tvítugur
starfad 	 starfað
íslandsmóti 	 Íslandsmóti
Vopnafirðier 	 Vopnafirði
tvem 	 tveim
Fornleyfarannsóknir 	 Fornleifarannsóknir
bandaríkjamegin 	 Bandaríkjamegin
Galías 	 Galíasar
tíðkuðst 	 tíðkuðust
tvem 	 tveim
Fornleyfarannsóknir 	 Fornleifarannsóknir
bandaríkjamegin 	 Bandaríkjamegin
Galías 	 Galíasar
tíðkuðst 	 tíðkuðust
Glúfurá 	 Gljúfurá
Madeira-eyjunum 	 Madeiraeyjum
Houston’s 	 Houston
probability 	 Probability
Yfirliett 	 Yfirleitt
Kastalanum 	 kastalanum
Viðskiptafræðinemendur 	 Viðskiptafræðinemar
tegnudir 	 tegundir
sæfjallaströnd 	 Snæfjallaströnd
rokk-hljómsveit 	 rokkhljómsveit
Rastafari 	 rastafari
Rastafari 	 rastafari
Rastafari 	 rastafari
Rastafari 	 rastafari
konungsríki 	 smákonungsríki
snýkjudýr 	 sníkjudýr
Francois 	 François
Jóhannessen 	 Johannessen
stöðugru 	 stöðugu
fjöllistarhópinn 	 fjöllistarhópsins
XSLT 	 XSL
ljósgrábrúnn 	 ljósgrábrúnir
kirkjustaðurá 	 kirkjustaður
Ólífræn 	 Ólífrænt
þyngdarfasti 	 þyngdarfastinn
Axlarblöð 	 Axlablöð
járnbrautarstjórnandar 	 járnbrautarstjórnendur
Liðskál 	 liðskál
Suðurnesjum 	 Suðurnesjunum
Holarktíska 	 holarktíska
oþann 	 þann
´Landnemi´ 	 Landnemi
Svíþjóð 	 SvíþjóðI
Slóvakía 	 Slóvakíska
Múmínálfur 	 múmínálfur
Snorksinns 	 Snorksins
Valintínus 	 Valentínus
hanns 	 hans
árunm 	 árunum
Amtmaður 	 amtmaður
Cannon 	 Cannons
Thorkelin 	 Thorkelín
Bláskógaskólinn 	 Bláskógaskóli
nátturuleg 	 náttúruleg
Chipita-héraðs 	 Chitipa-héraðs
eingnað 	 eignað
eingnað 	 eignað
ranlega 	 ranglega
rökkurdýr 	 rökkursdýr
demokrataflokksins 	 Demókrataflokksins
Austur-Miðhéruð 	 Austur-Miðhéruðum
Efnablanda 	 Efnablandaer
Giliturtt 	 Gilitrutt
Dómsdagsbókinnni 	 Dómsdagsbókinni
Portúgalir 	 Portúgalar
Flórídu 	 Flórída
Norwegicarum 	 Norvegicarum
Agamemnosar 	 Agamemnons
Byrjaði 	 byrjaði
Gagndagur 	 Gangdagur
Ingiríðastaðir 	 Ingiríðarstaðir
S-Þingeyjasýslu 	 S-Þingeyjarsýslu
Kyrrahafslúðu 	 kyrrahafslúðu
Rússneska 	 rússneska
mið-Rússlandi 	 Mið-Rússlandi
suðuramerísk 	 suður-amerísk
Lisbet 	 Lisbeth
Lisbet 	 Lisbeth
Lisbet 	 Lisbeth
Lisbet 	 Lisbeth
ítalskra 	 Ítalskra
Indónesíska 	 indónesíska
ráðstefnunni 	 CES-ráðstefnunni
ankaramíti 	 ankaramíts
Pýþagórískir 	 pýþagórískir
hestinu 	 hestinum
Zagros-fjöllum 	 Zagrosfjöllum
Þessarhreppsnefndarkosningar 	 hreppsnefndarkosningar
líf 	 líf-
shía-múslimar 	 sjía-múslimar
Ungmennafélagið 	 ungmennafélag
Ungmennafélag 	 Ungmennafélagið
Ungmennafélag 	 ungmennafélag
´´Ungmennafélagið 	 Ungmennafélagið
afbrygðissöm 	 afbrigðissöm
Þettbein 	 Þéttbein
Amelíuborg 	 Amalíuborg
Atferlisfræði 	 atferlisfræði
Þarfnast 	 þarfnast
ferming 	 Ferming
ferming 	 Ferming
Hassani 	 Hasani
Hasani 	 Hassani
حميد 	 حميدِ
Gaflinum 	 Gafflinum
stúd­ents­prófi 	 stúdentsprófi
Versl­un­ar­skóla 	 Verslunarskóla
indiehljómsveitir 	 indíhljómsveitir
Bitpop 	 Bitpopp
Veðurfarið 	 Veðurfar
aðgreinanlegasta 	 auðgreinanlegasta
alræmdasta 	 alræmdastu
eldsneytinð 	 eldsneytið
talnamengi 	 Talnamengi
Kjörinn 	 kjörinn
íslenskt 	 Íslenskt
heyrnalaust 	 heyrnarlausu
Handboltafélag 	 handboltafélag
Apollóníus 	 Apollóníos
Guy 	 Guys
Guðsbarna 	 guðsbarna
Búðarhraun 	 Búðahrauni
Frauðbein 	 Frauðbeinið
færeyjum 	 Færeyjum
Frauðbein 	 Frauðbeinið
færeyjum 	 Færeyjum
leghallir 	 Leghallir
Útskrifaðist 	 útskrifaðist
Japönsku 	 japönsku
Pólátunni 	 pólátunni
Íslensku 	 íslensku
vesturströndinni 	 Vesturströndinni
Manns 	 Mann
akreinir 	 akreinar
allsherjargoði 	 Allsherjargoði
Djúpbátsins 	 djúpbátsins
frádreggnir 	 frádregnir
Þungeind 	 Þungeindir
úrlistaleik 	 úrlslitaleik
Suð-Englandi 	 Suður-Englandi
Dómkerfið 	 Dómskerfið
bandaríkjaþingi 	 Bandaríkjaþingi
Kjalnesingasaga 	 Kjalnesingasögu
Vestur 	 Vestur-
Madiera 	 Madeira
fremdýrafræðingar 	 fremdardýrafræðingar
fán 	 fána
fremdýrafræðingar 	 fremdardýrafræðingar
fán 	 fána
Leikstýrði 	 leikstýrði
Województwo 	 województwo
karlkyn 	 Karlkyn
lífstíl 	 lífsstíl
Geitblaðsætt 	 geitblaðsætt
talnamengi 	 Talnamengi
Theodor 	 Theador
Theador 	 Theodor
brjósviði 	 brjóstsviði
Banffþjóðgarðurinn 	 Banff-þjóðgarðurinn
Eyvindastaðabardaginn 	 Eyvindastaðabardagi
Evrópukeppninni 	 Evrópukeppnin
Grenjaðarstöðum 	 Grenjaðarstað
sjálfstæðisdag 	 sjálfstæðisdegi
sjálfstæðisdag 	 sjálfstæðisdegi
Funeral 	 funeral
Sameiginlega 	 Sameiginlegi
Holtasóley 	 holtasóley
Hinn 	 Hin
Erkengilsborg 	 Erkiengilsborg
rúnugöldrum 	 rúnagöldrum
Ijsselmeers 	 IJsselmeers
yāʿiqōb 	 yāiqōb
yāiqōb 	 yāʿiqōb
Hvítleitt 	 hvítleitt
Landbúnað 	 Landbúnaður
sjálsprottinn 	 sjálfsprottinn
stadium 	 Stadium
Ozzie´s 	 Ozzies
Rastafari 	 rastafari
velbúnað 	 vélbúnað
Stafrófsmorðinne 	 Stafrófsmorðin
alphabet 	 Alphabet
Xenofon 	 Xenofoni
hljóðnældur 	 hljóðsnældum
skuldabréfa 	 Skuldabréfa
Dansaðu 	 dansaðu
dansaðu 	 Dansaðu
Austur-Frísnesku 	 Austurfrísnesku
dalbotnins 	 dalbotns
sinó-tíbetskt 	 sinó-tíbeskt
Fiskveiðin 	 Fiskveiði
Loroco-nafið 	 Loroco-nafnið
fernaldia 	 Fernaldia
Loroco-nafið 	 Loroco-nafnið
fernaldia 	 Fernaldia
sveitafélag 	 sveitarfélag
Gjallgígr 	 Gjallgígur
Stærðarmunur 	 stærðarmunur
hvílftarjökull 	 hvilftarjökull
Watts 	 Watt
óbygð 	 óbyggð
Rómverskur 	 rómverskur
myndanum 	 myndönum
Höfundur 	 höfundur
höfundur 	 Höfundur
orkudrykkin 	 orkudrykkinn
Íslendingaþætti 	 Íslendingaþættinum
ríkisstjórn 	 Ríkisstjórn
Þjóðsöngur 	 þjóðsöngur
Konungsríki 	 konungsríkis
þýskalandi 	 Þýskalandi
Arkangelsk 	 Arkhangelsk
Barilche 	 Bariloche
Framhaldsskóli 	 framhaldsskóli
Tortola 	 Tortóla
Bretalnd 	 Bretland
Carslberg 	 Carlsberg
Brautarskekkjunni 	 Brautarskekkjan
brautarhermun 	 brautarhermunar
Davíði 	 Davíð
nátturulega 	 náttúrulega
Viskusteinninn 	 viskusteinninn
Heimdallr 	 Heimdallur
Kameljónum 	 kameljónum
kjölfestu 	 kjölfestum
sjónvarpsmyndinn 	 sjónvarpsmyndinni
Píramídinn 	 Pýramídinn
dísel-rafmagns- 	 dísil-rafmagns-
´´Emerald 	 Emerald
Sinfónía 	 sinfónía
sinfónía 	 Sinfónía
Austurbæjarbíó 	 Austurbæjarbíói
Norðvestur-Ítalíu 	 Norðaustur-Ítalíu
Gotland 	 Gotlands
Tékkneska 	 tékkneska
samansettur 	 samansett
Mýósíni 	 mýósíni
akanmál 	 Akanmál
nigerkongó 	 nígerkongó
Framleiða 	 Framleiðsla
Þörungaverksmiðjan 	 þörungaverksmiðja
Principle 	 principle
Priority 	 priority
Niger-fljóts 	 Nígerfljóts
Tælensku 	 tælensku
Tíbesku 	 tíbesku
Japönsku 	 japönsku
neðstakaupstað 	 Neðstakaupstað
hæðstakaupstað 	 Neðstakaupstað
hæðstakaupstað 	 Hæstakaupstað
Fantasía 	 Fantasia
Fantasia 	 Fantasía
hljóðanum 	 hljóðönum
myndalegur 	 myndarlegur
Hin 	 Hinn
Threshold 	 threshold
málýskur 	 mállýskur
fimti 	 fimmti
nílendustjóri 	 nýlendustjóri
Þúsýdídesar 	 Þúkýdídesar
Machiavelli 	 Machiavellis
vísindagheimspeki 	 vísindaheimspeki
Rósaættbálkur 	 Rósabálkur
aðalverkefni 	 Aðalverkefni
stríðsskáldum 	 stríðsskáldi
sprungu-og 	 sprungu-
norvesturhluta 	 norðvesturhluta
Billjón 	 milljón
Wirral-skagi 	 Wirral-skaga
dómkirkjaí 	 dómkirkja
argentínksi 	 argentínski
Smásagnasafn 	 smásagnasafn
Hryefiorka 	 Hreyfiorka
Katalónska 	 Katalónsku
Katalónska 	 katalónska
khisanmálunum 	 koisanmálunum
afró-asísku 	 afróasísku
Eignarfallið 	 eignarfallið
eignarfallið 	 Eignarfallið
Toskanahéraðs 	 Toskanahéraði
Austurfrísnesku 	 austurfrísnesku
víðlesnastu 	 víðlesnustu
Pac-man 	 Pac-Man
Bandarískt 	 bandarískt
Abrahamísku 	 abrahamísku
Hverfahlutinn 	 Hverfishlutinn
Forseta 	 forseta
UHF-útsendingar 	 UHF-útsendingum
íslendingar 	 Íslendingar
Tanganyikavatn 	 Tanganjikavatn
Febrúar 	 febrúar
Telefórusar 	 Telesfórusar
Antóníusar 	 Antónínusar
stjórmálamaður 	 stjórnmálamaður
Miðborg 	 Miðborgar
Napoleon 	 Napóleon
sjálfkraka 	 sjálfkrafa
Beinabygging 	 beinabyggingu
þéttiþurrkari 	 Þéttiþurrkari
lífeyris 	 lífeyris-
Oneirokritikon 	 Oneirokritika
Litlaus 	 litlaus
rækjunar 	 rækjurnar
Búðarhraun 	 Búðahraun
Framleiddi 	 framleiddi
einsykrur 	 Einsykrur
sykursameind 	 sykrusameind
stjarnarn 	 stjarnan
Oddviti 	 oddviti
Íslenskt 	 íslenskt
Íslenskt 	 íslenskt
Miðjarahafi 	 Miðjarðarhafi
suður-Kyrrahafi 	 Suður-Kyrrahafi
Knattspyrnufélag 	 knattspyrnufélag
knattspyrnufélag 	 Knattspyrnufélag
Rangarþingi 	 Rangárþingi
austur-flæmingjalandi 	 Austur-Flæmingjalandi
eiginleika 	 Eiginleikar
Fjallafura 	 fjallafura
Umgmennafélagið 	 Ungmennafélagið
Vidzema 	 Vidzeme
Pýrenafjöllin 	 Pýreneafjöllin
Nemstov 	 Nemtsov
austjóskir 	 austurjóskir
Ijsselmeer 	 IJsselmeer
Félags 	 Félag
austjóskir 	 austurjóskir
Ijsselmeer 	 IJsselmeer
Félags 	 Félag
Blücker 	 Blücher
framúrskaranda 	 framúrskarandi
fótgönguliðsundrifylkja 	 fótgönguliðsundirfylkja
Valla-Ljótur 	 Valla-Ljóts
Hyalospora 	 Hyalopsora
Góðravonarhöfða 	 Góðrarvonarhöfða
Íslenskum 	 íslenskum
ansjónan 	 ansjósan
Calígula 	 Calígúla
Lögmanni 	 lögmanni
frjóðguð 	 frjóvguð
Móskarðshnjúkar 	 Móskarðahnjúkar
Sjófulgabyggðir 	 Sjófuglabyggðir
Statford 	 Stratford
Suðuroy 	 Suðurey
Suðurey 	 Suðuroy
Bantúmál 	 bantúmál
Ýviðarætt 	 ýviðarætt
Tékknesk 	 tékknesk
tékknesk 	 Tékknesk
neðangreinndu 	 neðangreindu
tónlistastefna 	 tónlistarstefna
fjölmiðkum 	 fjölmiðlum
fleygrýnir 	 fleygrúnir
fleygrýnir 	 fleygrúnir
rolluvetur 	 Rolluvetur
rollubani 	 Rollubani
Royal 	 Royale
Alþingiskosningarnar 	 Alþingiskosningar
eftir 	 efti
Lífdísilolía 	 Lífdísill
limafirði 	 Limafirði
Stundaði 	 stundaði
Grunnskóli 	 grunnskóli
gjörningaverkum 	 gjörningaverk
pýramídarnir 	 pýramdarnir
Gilgamesh-kviðan 	 Gilgameskviða
Dmitri 	 Dimitri
Dökknar 	 dökknar
innihaldur 	 inniheldur
Al-Sadat 	 al-Sadat
Góðhestar 	 góðhestar
Chluana 	 Chluain
Voldemortog 	 Voldemort
einig 	 einnig
Edouard 	 Édouard
Extremadúra 	 Extremadura
Extremadura 	 Extremadúra
Braglínan 	 Braglína
Skipti 	 Skipting
færeyinga 	 Færeyinga
íslendinga 	 Íslendinga
Braglínan 	 Braglína
Skipti 	 Skipting
færeyinga 	 Færeyinga
íslendinga 	 Íslendinga
skjaldarberar 	 skjaldberar
uppréttann 	 upprétta
kjarnorkustýristangir 	 kjarnorkustýristöngum
Hebreska 	 hebreska
Eyjarfjarðarsveit 	 Eyjafjarðarsveit
Philadelphia 	 Philadelphiu
Mangótrésins 	 mangótrésins
Bandaríski 	 bandaríski
Nasreddíns 	 Nasreddins
kúni 	 kúnni
Bronsöldin 	 bronsöldin
pungrækjur 	 pungrækjum
Kongó-páfuglinn 	 kongó-páfuglinn
undirættkvíslarinnar 	 undirættkvíslar
bleading 	 bleeding
Íslenskra 	 íslenskra
færeyja 	 Færeyja
Tíkarrass 	 tíkarrass
pönkhljómsveit 	 pönkpopphljómsveit
King 	 Kings
Norfolk 	 Norfolki
Spence 	 Spencer
Ástralska 	 ástralska
Norðurlandaráðsþingi 	 Norðurlandaráðs
Norðurlandaráðsþingi 	 Norðurlandaráði
framhalf 	 framhald
rússlandi 	 Rússlandi
sjónvilluu 	 sjónvillu
Genfarsamninginn 	 Genfarsamningsins
dúnfjáðrir 	 dúnfjaðrir
Landssambandi 	 Landssambands
dúnfjáðrir 	 dúnfjaðrir
Landssambandi 	 Landssambands
mið 	 mið-
norðaustur-Asía 	 norðaustur-Asíu
hinsegin 	 Hinsegin
Sveitarfélag 	 sveitarfélag
Pompei 	 Pompeii
ríkissjónvarpinu 	 Ríkissjónvarpinu
eingin 	 engin
Ritlist 	 ritlist
Rússneskt 	 rússneskt
Amerískum 	 amerískum
fótbola 	 fótbolta
lifrurnar 	 Lifrurnar
Vanmálmarnir 	 málmarnir
Balantine 	 Ballantine
ástralska 	 Ástralska
Watlzing 	 Waltzing
tenglsum 	 tengslum
Imipenem 	 imipenem
Meropenem 	 meropenem
Ertapenem 	 ertapenem
Doripenem 	 doripenem
norðraustri 	 norðaustri
norðvesturhlusta 	 norðvesturhluta
Formaður 	 formaður
færeyingar 	 Færeyingar
Formaður 	 formaður
færeyingar 	 Færeyingar
Vestrómverska 	 vestrómverska
Kronosar 	 Krónosar
Fjölmörn 	 Fjölmörg
Fornleifauppgröfturhefur 	 Fornleifauppgröftur
He’s 	 Hes
klausturreglana 	 klausturreglnanna
frelsisstyttan 	 Frelsisstyttan
Gælunaf 	 Gælunafn
meðallíftíma 	 meðallíftímann
Padova 	 Padoa
Padoa 	 Padova
Tónlistarverðlaunanna 	 tónlistarverðlaunanna
Ferðaðist 	 ferðaðist
Forseta 	 forseta
sikileyksu 	 sikileysku
suðvestur-Utah 	 Suðvestur-Utah
Hjaltlandseyjar 	 Hjaltlandseyjum
einundirgrein 	 undirgrein
Soul 	 Souls
Andalucíaer 	 Andalucía
Suður-Spánn 	 Suður-Spáni
fjölmennasta 	 næstfjölmennasta
hæðstakaupstað 	 Hæstakaupstað
kóngakrabbanum 	 gullkóngakrabbanum
George 	 Georg
nábílismanns 	 nábýlismanns
breiðskífurnar 	 Breiðskífurnar
Áhangangendur 	 Áhangendur
Dalakollsson 	 Dala-Kollsson
sytting 	 stytting
Nu-metal 	 nu-metal
Petroffsvörn 	 Petrovsvörn
JKRowling 	 Rowling
Caligúlu 	 Caligúla
Upplýsingaröld 	 Upplýsingaöld
Wikipedia 	 Wikipediu
Japönskum 	 japönskum
Samoyed-hundinum 	 samoyed-hundinum
þrálaus 	 þráðlaust
alþjóðablóðgjafardaginn 	 Alþjóðablóðgjafardaginn
Flugherstöðin 	 flugherstöðin
Einisætt 	 einisætt
fyr 	 fyrr
Eiðssker 	 Eiðissker
Flateyrarannáll 	 Flateyjarannáll
Flateyrarannáll 	 Flateyjarannáll
Túnfiskur 	 túnfiskur
íslendingar 	 Íslendinga
inuítamál 	 inúítamál
Línusar 	 Línosar
Kardimommubærinn 	 Kardemommubærinn
stórhertogadæmi 	 stórhertogadæminu
Lúðrasveitarinnar 	 lúðrasveitarinnar
majónesi 	 majonesi
Hainauts 	 Hainaut
Antigonus 	 Antigonos
ryðfríðu 	 ryðfríu
Tölvunarfræðingur 	 tölvunarfræðingur
Laugavatni 	 Laugarvatni
æðakóngs 	 æðarkóngs
dúnni 	 dúni
Oneirokritikon 	 Oneirokritika
aíníska 	 Aíníska
byggdarlagi 	 byggðarlagi
Viktoríuvatnið 	 Viktoríuvatns
brjóstast 	 brjótast
Einfald 	 Einfalt
kjarnaeindar 	 kjarneindar
Landssambandi 	 Landssambands
Einfald 	 Einfalt
kjarnaeindar 	 kjarneindar
Landssambandi 	 Landssambands
yngsta 	 yngsta-
vaðhafið 	 Vaðhafið
scheduling 	 Scheduling
annari 	 annarri
pinninn 	 Pinninn
hátíðin 	 Hátíðin
ul-Fitr 	 al-Fitr
Röntgengeislar 	 Röntgengeislun
Íslenska 	 íslenska
Róðrígó 	 Ródrígó
hundruði 	 hundruð
Ítölskum 	 ítölskum
Grískum 	 grískum
lýdíska 	 lidíska
brasilíksa 	 brasilíska
hljóð-effectum 	 hljóðeffektum
sóleyjarætt 	 sóleyjaætt
reykjanesi 	 Reykjanesi
endurreist 	 endurreisna
sóleyjarætt 	 sóleyjaætt
Hugrakka 	 hugrakka
Ijsselmeer 	 IJsselmeer
kynliður 	 Kynliður
Gametophyte 	 gametophyte
fjalægð 	 fjarlæg
numerology 	 Nnumerology
numerology 	 Nnumerology
Reykajvíkur 	 Reykjavíkur
Univeristy 	 University
tvígildislögmáli 	 tvígildislögmálið
Mistilteinn 	 mistilteinn
óskarað 	 óskaraða
óskarað 	 óskaraða
Ormurinn 	 Ormurin
Patagonía 	 Patagonia
Patagonia 	 Patagonía
kúbverjum 	 Kúbverjum
Ammoníumklóríði 	 ammoníumklóríði
Atvinnulífsins 	 atvinnulífsins
herskildir 	 herskyldir
sjárútvegsfyrirtæki 	 sjávarútvegsfyrirtæki
ísafirði 	 Ísafirði
Syðragarðshotn 	 Syðragarðshorn
Hindúisma 	 hindúisma
katalanska 	 katalónska
veggsjpaldinu 	 veggspjaldinu
avarska 	 Avarska
Sætbjörk 	 sætbjörk
fimtánda 	 fimmtánda
kvikmind 	 kvikmynd
þekttust 	 þekktust
fimtánda 	 fimmtánda
kvikmind 	 kvikmynd
þekttust 	 þekktust
Carnigie 	 Carnegie
málminnihlutahópum 	 málminnihlutahóp
Hnúðlax 	 hnúðlax
menntunarkerfum 	 menntakerfum
greinamur 	 greinarmunur
norðvestum 	 norðvestur
ína 	 Nína
Loðumundarfjarðar 	 Loðmundarfjarðar
framhaldsskólans 	 Framhaldsskólans
örgjörfum 	 örgjörvum
Hyperion 	 Hyperíon
Antimon 	 Antímon
mótmælandatrú 	 mótmælendatrú
Miðöldum 	 miðöldum
Barack 	 Baracks
Hass­an 	 Hassan
Hass­an 	 Hassan
Rou­hani 	 Rouhani
روحانی‎‎ 	 روحانی
Hellisheiðavirkjun 	 Hellisheiðarvirkjun
Hussaini 	 Hussainia
hálfkirkja 	 Hálfkirkja
myndasöguhöfundurSacco 	 myndasöguhöfundur
landfræðilegru 	 landfræðilegri
fjárfestingabankur 	 fjárfestingabanki
unlinga-gamanmynd 	 unglinga-gamanmynd
Almennu 	 almennu
kvígúkálfa 	 kvígukálfa
Mongólska 	 mongólska
vestur-Mongólíu 	 Vestur-Mongólíu
indíánamál 	 indjánamál
Pokémonar 	 Pokémonarnir
Funeral 	 funeral
Pócahontas 	 Pókahontas
Pócahontas 	 Pocahontas
Marsíli 	 marsíli
rugbrauð 	 rúgbrauð
remolaði 	 remúlaði
greinamerki 	 greinarmerki
‘Söluéttarsamningur‘‘‘ 	 Söluéttarsamningur
Wesminster 	 Westminster
Þingeyjarsýslur 	 Þingeyjasýslunar
Ísabella 	 Isabella
Isabella 	 Ísabella
Ítalskir 	 ítalskir
Sagnfræðingar 	 sagnfræðingar
Akershus 	 Akershús
Akershus 	 Akershús
Krabbamein 	 Krabbameinið
hæðsta 	 hæsta
Jacksons 	 Jackson
Síðasta 	 síðasta
vítæku 	 víðtæku
margbretyilegu 	 margbreytilegu
Pýþógórasar 	 Pýþagórasar
fornheimspekinga 	 heimspekinga
flugatvika 	 flugatvik
Fjölbrautarskólann 	 Fjölbrautaskólann
míkró-og 	 míkró-
Styrkjamálaið 	 Styrkjamálið
internetþáttunum 	 internetþættinum
Snípuætt 	 snípuætt
einning 	 einnig
einning 	 kenning
nátturuval 	 náttúruval
Claudiusar 	 Claudíusar
GNU 	 GNUs
GNU 	 GNUs
GNUs 	 GNU
GNUs 	 GNU
Bandarísk 	 bandarísk
þungarokkshljósveit 	 þungarokkshljómsveit
A-Húnaþingi 	 Húnaþingi
Don´t 	 Dont
A-Húnaþingi 	 Húnaþingi
Don´t 	 Dont
Gaulista 	 Gaullista
Gresjufíllinn 	 gresjufíllinn
Skógarfíllinn 	 skógarfíllinn
verkamannaflokkinn 	 Verkamannaflokkinn
ENglands 	 Englands
Hermesarstafinum 	 Hermesarstafnum
Asklepiosarstafinum 	 Asklepiosarstafinn
Hettuaparnir 	 Hettuapar
Fransisco 	 Francisco
Háksóla 	 Háskóla
nightmare 	 Nightmare
Íslenskt 	 íslenskt
Appalasíafjöllum 	 Appalasíufjöllum
Knattspyrnufélagið 	 knattspyrnufélag
Blómstrar 	 blómstrar
Berkmann 	 Berkman
fengizt 	 fengist
Híeróglýfurnar 	 híeróglýfurnar
norðmanna 	 Norðmanna
hlapðvarpsþáttur 	 hlaðvarpsþáttur
hesturinn 	 Hesturinn
rúþen-mólybden 	 rúten-mólybden
snériltrommum 	 sneriltrommum
jarnstandi 	 járnstandi
afriskri 	 afrískri
Schnauzer 	 schnauzer
Minneapolis–Saint 	 Minneapolis-Saint
ósyntir 	 ósyndir
Baikalvatni 	 Bajkalvatni
Kéttirnir 	 Kettirnir
Vatnsvík 	 Vatnsvik
Agonisti 	 agonisti
hjarðir 	 ihjarðir
austur-indía-félaginu 	 Austur-Indíafélaginu
Ytragarðshotn 	 Ytragarðshorn
fjögura 	 fjögurra
Osman 	 Osmans
Abkasíska 	 abkasíska
firrverandi 	 fyrrverandi
háskólan 	 háskólann
̉Αθηνόδωρος 	 Ἀθηνόδωρος
aserbaídsjíska 	 aserbaídsjanska
Bókmenntarýni 	 bókmenntarýni
bókmenntarýni 	 Bókmenntarýni
hugleiðingar 	 ef-hugleiðingar
Eldland 	 Eldlandið
ragnarrökum 	 ragnarökum
fjörtum 	 fjötrum
ragnarrökum 	 ragnarökum
fjörtum 	 fjötrum
logistic 	 Logistic
hafnarboltanum 	 hafnarbolta
Miðsóknarkraftur 	 miðsóknarkraftur
Mýlislíður 	 Mýlisslíður
Bandalagið 	 bandalagið
timímabilinu 	 tímabilinu
stofnðu 	 stofnuð
verslunamiðstöðvar 	 verslunarmiðstöðvar
heimstyrjöldina 	 heimsstyrjöldina
Birkiætt 	 birkiætt
Antilópur 	 antilópur
O´Donnell 	 ODonnell
jafnvél 	 jafnvel
Íshokkífélag 	 íshokkífélag
Hundarós 	 hundarós
gráloddur 	 Gráloddur
Metamorphosis 	 Metamorphoses
Ijsselmeer 	 IJsselmeer
Jómfrúreyjar 	 Jómfrúaeyjar
kampavínsvínþúgurnar 	 kampavínsþrúgurnar
Kanelsykur 	 Kanilsykur
Children´s 	 Childrens
Orðrómar 	 Orðrómur
einfaldega 	 einfaldlega
Kraftar 	 Kraftur
Norður-Atlandshafi 	 Norður-Atlantshafi
Malcolm 	 Malcolms
Elijah 	 Elijahs
Mannerismi 	 Manierismi
hynslóða 	 kynslóða
Híeróglýfurnar 	 híeróglýfurnar
Kínverskir 	 kínverskir
Neanderdalsmanna 	 neanderdalsmanna
Auðveldur 	 auðveldur
nemandafélag 	 nemendafélag
nemandafélag 	 nemendafélag
nemandafélag 	 nemendafélag
nemandafélag 	 nemendafélag
ninhursag 	 Ninhursag
Veirifræði 	 Veirufræði
vinulágið 	 vinulágin
Vaðlavík 	 Vaðalvík
guðmundssyni 	 Guðmundssyni
sambandríkisins 	 sambandsríkisins
Theramin 	 Theremin
þeramínið 	 þeremínið
Skótlandi 	 Skotlandi
Andrey 	 Andrejy
Astýanax 	 Astýnax
annari 	 annarri
botnvörpumsem 	 botnvörpum
frumulíffær 	 frumulíffæri
frumulíffær 	 frumulíffæri
alment 	 almennt
konúngur 	 konungur
DrGregory 	 Gregory
aðstoðarskólastýra 	 aðstoðarskólastjóri
micropezid 	 Micropezid
kats 	 khats
Lífverur 	 lífverur
lífverur 	 Lífverur
dögu 	 dögum
Hippokratesar 	 Hippókratesar
ericoideser 	 ericoides
ericoideser 	 ericoides
Íslenskur 	 íslenskur
Hafanar 	 Hafnar
rennilásina 	 rennilásinn
Stundaði 	 stundaði
brúðguman 	 brúðgumann
Fjarðafylki 	 Firðafylki
ríkistjórnum 	 ríkisstjórnum
Repúblikananum 	 repúblikananum
atabaskamál 	 Atabaskamál
d-vítamíni 	 D-vítamíni
O‘Reilly 	 OReilly
Blöðflögur 	 Blóðflögur
Mannréttindadómstóls 	 Mannréttindadómstól
Kazakstan 	 Kasakstan
Íslenska 	 Íslenski
mustang 	 Mustang
verndar 	 verndar-
Fylking 	 fylking
fylking 	 Fylking
Íslenska 	 Íslenski
mustang 	 Mustang
verndar 	 verndar-
Fylking 	 fylking
fylking 	 Fylking
Evrópumeistari 	 evrópumeistari
tóniki 	 tónik
Úrsökin 	 Orsökin
Koddaskeljana 	 Koddaskeljanna
íslenska 	 Íslenska
Íslenskri 	 íslenskri
kvennkyn 	 kvenkyn
byrtist 	 birtist
majónsósa 	 majonsósa
nasaholana 	 nasaholanna
Neanderdalsmanna 	 neanderdalsmanna
Theatre 	 Theater
Heinamaa 	 Heinämaa
Píramídinn 	 Pýramídinn
Pecificus 	 pecificus
Sole 	 Solea
Stjörnugægja 	 stjörnugægja
rocknroll 	 rock’n’roll
Sviðinu 	 sviðinu
Þegundirnar 	 Tegundirnar
Skagafirðifrá 	 Skagafirði
ókeipis 	 ókeypis
Fræðiheiti 	 fræðiheiti
Þjóðgarður 	 Þjóðgarðar
arionidae-ætt 	 Arionidae-ætt
risakini 	 risakyni
föurætt 	 föðurætt
nýji 	 nýi
MezzoForte 	 Mezzoforte
bræðingshlómveit 	 bræðingshlómsveit
boraverksmiðju 	 borverksmiðju
Fjalabrun 	 Fjallabrun
Fjalabrun 	 Fjallabrun
Sjaldgæft 	 sjaldgæft
mettunareimþrýstingur 	 mettunarþrýstingur
Kunyomi 	 kunyomi
Leonska 	 Leónska
Mac 	 Mach
Mrgrét 	 Margrét
Stundarinar 	 Stundarinnar
veturtinn 	 veturinn
heimstyrjöldinni 	 heimsstyrjöldinni
heilsuvandamál 	 heilsuvandamálum
japansk 	 japanska
silíkat-steind 	 sílíkatsteind
Iðnbyltinginni 	 iðnbyltingunni
flutningarhöfn 	 flutningahöfn
Rúllstigi 	 Rúllustigi
Samúræji 	 Samúræi
Íslensk 	 íslensk
Fetafiðrildaætt 	 fetafiðrildaætt
samanstendur 	 Samanstendur
úran- 	 úrans-
Telefórus 	 Telesfórus
Gen 	 Gene
erðafræði 	 erfðafræði
austugermönsk 	 austurgermönsk
Stravinsky 	 Stravinskíj
Kúbönskum 	 kúbönskum
Everyboy 	 Everybody
Suður-Evróðu 	 Suður-Evrópu
Vesturhluta 	 vesturhluta
Tungumál 	 tungumál
Búrgunda 	 Búrgundar
Donatellu 	 Donatello
uppgvötvaðir 	 uppgötvaðir
Frðrik 	 Friðrik
uppgvötvaðir 	 uppgötvaðir
Frðrik 	 Friðrik
Ótrúlegu 	 ótrúlegu
hrossaflugna 	 Hrossafluga
Krossmessa 	 Krossmessu
frönsku 	 frönska
Yerevan 	 Jerevan
höfuborg 	 höfuðborg
Prentnám 	 prentnám
Kremlið 	 Kremlin
nykurætt 	 nykruætt
Nefnifallið 	 nefnifallið
Latínunni 	 latínunni
nefnifallið 	 Nefnifallið
Laumonít 	 Laumontít
skautasvæði 	 skautasvæðið
Miðasíu 	 Mið-asíu
Búddaprestur 	 búddaprestur
Múrmledýr 	 Múrmeldýr
Evrópskum 	 evrópskum
Risaostra 	 risaostra
Keflvísk 	 keflvísk
landslið 	 Landslið
Leuciscus 	 leuciscus
leuciscus 	 Leuciscus
skriafði 	 skrifaði
Killaminati 	 Killuminati
Upphafstafaheiti 	 Upphafsstafaheiti
Musteri 	 musteri
Tunglið 	 tunglið
Instrúmental 	 instrúmental
sungið 	 Ósungið
djöflaeyjan 	 Djöflaeyjan
Fjólublátt 	 fjólublátt
uppgövanir 	 uppgötvanir
ójönunni 	 ójöfnunni
Stór-Chiloéey 	 Stóra-Chiloéey
Evrópskra 	 evrópskra
júkulele 	 úkulele
áræðanlegar 	 áreiðanlegar
hæðstakaupstað 	 Hæstakaupstað
Pierres 	 Pierre
eyjólfsdóttir 	 Eyjólfsdóttir
ingimars 	 Ingimars
mismunani 	 mismunandi
Jarðsveppur 	 Jarðkeppur
hjarta-og 	 hjarta-
frmlag 	 framlag
Suður-England 	 Suður-Englandi
Norður-England 	 Norður-Englandi
raka 	 raka-
einandrandi 	 einangrandi
Bólívar 	 Bolívar
Fræðiheiti 	 fræðiheiti
frumbyggjatungumálum 	 frumbyggjatungumálunum
Reaction 	 reaction
Christopher 	 Christophers
þrýstingarmuni 	 þrýstingsmuni
Instrument 	 Instruments
örgjörfa 	 örgjörva
einhlýtt 	 einhlítt
Bangladesh 	 Bangladess
Blaðlúsaætt 	 blaðlúsaætt
Balkanskagan 	 Balkanskaga
artifiose 	 artificiose
dæmisögur 	 Dæmisögur
Eidvsoll 	 Eidsvoll
Atlandshafi 	 Atalandshafi
Sumardaginn 	 sumardaginn
Alþýðulíðveldisins 	 Alþýðulýðveldisins
Sumardaginn 	 sumardaginn
Alþýðulíðveldisins 	 Alþýðulýðveldisins
ástrónesíst 	 ástrónesískt
Seltjarnarnesinu 	 Seltjarnarness
Seltjarnarnesinu 	 Seltjarnarnesi
íslendingaNN 	 ÍslendingaNN
eyunni 	 eyjunni
Hraunsbænda 	 Hraunabænda
Databese 	 Database
jarðskjálftafræðingar 	 skjálftafræðingar
httpkirkjanisumL 	 httpkirkjanisumC
æfilangt 	 ævilangt
Körfuknattleiksfélag 	 körfuknattleiksfélag
biomathematics 	 Biomathematics
stöðugleikakerfi 	 ESC-stöðugleikakerfi
Naktardans 	 Nektardans
Ráðherrarnefndin 	 Ráðherranefndin
ráðherranefndir 	 Ráðherranefndin
myndirer 	 myndir
flutt 	 flutzt
prentunartæki 	 prentunartækjum
ströndinni 	 Ströndinni
vigursvið 	 vigursviði
vigursviði 	 vigursvið
mycorrhiza 	 Mycorrhiza
litningaenda 	 litningsenda
zinkbsteinda 	 zinksteinda
Rússneska 	 rússneska
Arnarfellin 	 Arnarfell
Arnarfellin 	 Arnarfell
Arnarfellin 	 Arnarfell
Marþöll 	 marþöll
Fjallaþöll 	 fjallaþöll
assyríska 	 Assyríska
flæmsk-hollensku 	 flæmsk-hollenskt
Norðurhlíð 	 Norðurhlið
Algenasta 	 Algengasta
koarsúlfíðsteindin 	 koparsúlfíðsteindin
Forsiðumyndina 	 Forsíðumyndina
feingar 	 fengar
plöntur 	 Plöntur
Forsiðumyndina 	 Forsíðumyndina
feingar 	 fengar
plöntur 	 Plöntur
Gilgamesh 	 Bilgamesh
súmerskt 	 súmerska
Bilgamesh 	 Gilgamesh
Eyjafirðir 	 Eyjafirði
kyrrahafinu 	 Kyrrahafinu
rafmagnsnerta 	 rafmagnssnertur
þekktasur 	 þekktastur
Nu-metals 	 nu-metals
austur-strönd 	 austurströnd
adríahafsins 	 Adríahafsins
tilheirir 	 tilheyrir
arfbundin 	 arfbundinn
Sorpsjórnun 	 Sorpstjórnun
sprungurein 	 Sprungurein
littlum 	 litlum
vigureiningu 	 vigurgreiningu
tánað 	 táknað
unkringir 	 umkringir
JPrimera 	 Primera
Vladivostok 	 Vladívostok
karldýrin 	 Karldýrin
vörutegund 	 Vörutegund
Þvagrásin 	 Þvagrás
Knattspyrnufélagi 	 Knattspyrnufélag
aktiníðar 	 aktiníð
myslnublöndunni 	 mylsnublöndunni
Böggvistaðafjall 	 Böggvisstaðafjall
kvenkynslíkana 	 kvenkynslíkama
bandaríkjamönnum 	 Bandaríkjamönnum
saxófónaro 	 saxófónar
saxófónaro 	 saxófónar
Geimfari 	 geimfari
STMskammtímaminni 	 skammtímaminni
LTMlangtímaminni 	 langtímaminni
Greifadæmið 	 greifadæmi
greifadæmi 	 Greifadæmið
sóleyjarætt 	 sóleyjaætt
arabaheiminum 	 Arabaheiminum
grasætt 	 grasaætt
menntasofnun 	 menntastofnun
kísilhnúðri 	 kísilhrúðri
sjálfmyndar 	 sjálfsmyndar
félagfærni 	 félagsfærni
merkingarvefum 	 merkingarvefjum
Ræðumaður 	 ræðumaður
Ræðumaður 	 ræðumaður
glóðaþræði 	 glóðarþræði
Venesúelu 	 Venesúela
bandríkjunum 	 Bandríkjunum
Norður-Atlanshafi 	 Norður-Atlantshafi
╰─Þórður 	 ├─Þórður
Ausfjörðum 	 Austfjörðum
strangtrúar 	 strangtrúaðir
Dagskrárgerð 	 dagskrárgerð
verðferðarkerfið 	 velferðarkerfið
örorkulífeyribóta 	 örorkulífeyrisbóta
Þangdoppa 	 Þangdoppu
þjóðbókasafn 	 Þjóðbókasafn
Egypsku 	 egypsku
stoðdeild 	 stoðdeildir
aímaríska 	 Aímaríska
aímaríska 	 aímarískt
Iðnaðarframleiðslufyrirtækið 	 iðnaðarframleiðslufyrirtæki
stofað 	 stofnað
franska 	 Franska
Indóevrópskt 	 indóevrópskt
franska 	 Franska
Indóevrópskt 	 indóevrópskt
reikningslistarinnar 	 Reikningslistarinnar
Austur-Atlandshafinu 	 Austur-Atlantshafinu
þanig 	 þannig
Hómelíubók 	 Hómilíubók
Gústafsstríðið 	 Gústafsstríðin
Skandinavíufjöll 	 Skandinavíufjöllum
lögþingsformaður 	 lögþingsformaðurinn
Maríubjöllur 	 maríubjöllur
Parsa 	 Parsua
Parsua 	 Parsa
vinstri 	 Vinstri
blautum 	 Blautum
Kaírós 	 Kaíró
Þekktastu 	 Þekktustu
Tölfræði 	 tölfræði
Setning 	 setning
Tölfræðinnar 	 tölfræðinnar
Smokkfiskur 	 Smokkfiskar
Sandsíli 	 Strandsíli
mississippi 	 Mississippi
Pólinesíu 	 Pólynesíu
milimetrum 	 millimetrum
Rafpóstur 	 rafpóstur
eingin 	 engin
Víkinga-þungarokkinu 	 víkingaþungarokkinu
svörtu- 	 svörtu
þjóðlaga-þungarokki 	 þjóðlagaþungarokki
Þjóðarinnar 	 þjóðarinnar
Palearktísku 	 palearktísku
Sokrates 	 Sókrates
færeyja 	 Færeyja
Joenssen 	 Joensen
Austurfrísnesku 	 austurfrísnesku
föníkumenn 	 Föníkumenn
SKólinn 	 Skólinn
Ijsselmeer 	 IJsselmeer
áttján 	 átján
Meginland 	 meginland
Jómfrúreyjar 	 Jómfrúaeyjar
Kjúllinn 	 Kjúlli
aðalega 	 aðallega
kjarnorku-vígbúnaðarkapphlaupið 	 kjarnorkuvígbúnaðarkapphlaupið
Latabæjar 	 Latarbæjar
ljósmyndari 	 Ljósmyndari
tilheira 	 tilheyra
Catalouge 	 Catalogue
Montreal 	 Montréal
ýmisa 	 ýmis
Múnda-mál 	 Múndamál
ástró-asískra 	 ástróasískra
jörðuna 	 jörðina
Þískalandi 	 Þýskalandi
Ríos-fylku 	 Ríos-fylki
Ríkislögreglustjóri 	 Ríkislögreglustjórinn
klarinett 	 klarínett
stefáns 	 Stefáns
Hölter 	 Hölters
Hölters 	 Hölter
veggum 	 veggjum
Fyrirbærafræðileg 	 fyrirbærafræðileg
Víkina-þungarokk 	 Víkingaþungarokk
skráarsniðið 	 skráarsnið
skráarsnið 	 skráarsniðið
netvafrarann 	 netvafrann
Holsetalandi 	 Holtsetalandi
Aleutíska 	 Aleútíska
Arsenyevitsj 	 Arsenjevitsj
Balkanbandalagsins 	 Balkanskagabandalagsins
Bilbo 	 Bilbao
Bilbao 	 Bilbo
Sebastian 	 Sebastián
Abrigðið 	 Afbrigðið
Nautgripir 	 nautgripir
Norður-Californíu 	 Norður-Kaliforníu
Þvermál 	 þvermál
þvermál 	 Þvermál
massaminna 	 massaminni
Harmhvæli 	 Harmkvæli
tilbeiðslumyndum 	 tilbeiðslumynda
náskildar 	 náskyldar
Japonicus 	 japonicus
Þekkist 	 þekkist
björgunarsveitarinn 	 björgunarsveitarinnar
Austur-Flæmingjaland 	 Austur-Flæmingjalandi
Eystri-Pétursey 	 Vestri-Pétursey
Vestri-Pétursey 	 Eystri-Pétursey
Nikhóll 	 Nykhóll
Ertublómaætt 	 ertublómaætt
erfðaupplýsingar 	 erfðaupplýsinga
tölvna 	 tölva
Valakíu 	 Vallakíu
Þjóðgarður 	 þjóðgarður
Þriggja 	 þriggja
Tony 	 Tonys
Arabískt 	 arabískt
Hollensk 	 hollensk
bandsög 	 Bandsög
Kristíaníu 	 Kristjaníu
Fornpersneska 	 fornpersneska
Hesse 	 Hessen
skipting 	 Skipting
loðréttum 	 lóðréttum
Fornpersneska 	 fornpersneska
Hesse 	 Hessen
skipting 	 Skipting
loðréttum 	 lóðréttum
ræktunarafbriðgi 	 ræktunarafbrigði
meðal 	 meðal-
Túnfiskur 	 túnfiskur
Lorenco 	 Lorenzo
íslendinga 	 Íslendinga
Kantabria 	 Kantabría
Kantabria 	 Cantabria
Kapítal 	 Kapítól
Keltneskt 	 Keltnesku
Kornabretland 	 Kornbretaland
stjórnmálamaðir 	 stjórnmálamaður
Fræðiheiti 	 fræðiheiti
Koddaskeljarnar 	 koddaskeljarnar
Konungar 	 konungar
konungar 	 Konungar
saltpétursýru 	 saltpéturssýru
Þorskur 	 þorskur
metýlínblátt 	 metýlenblátt
mongólar 	 Mongólar
Otiorhynchus 	 Otiorrhynchus
Otiorrhynchus 	 Otiorhynchus
Edinburg 	 Edinborg
skjöldin 	 skjöldinn
spatthaltir 	 spatthelti
spatthelti 	 spatthaltir
Síkisma 	 síkisma
glóaldinsætt 	 glóaldinætt
tadsjiskra 	 tadsjískra
þurkuð 	 þurrkuð
teplöntunar 	 teplöntunnar
Veraldarvefurinn 	 veraldarvefurinn
Norrænni 	 norrænni
nokkura 	 nokkurra
Crocrodylus 	 Crocodylus
Biskupastríðið 	 Biskupastríðin
eyarklasi 	 eyjaklasi
suður-Chile 	 Suður-Chile
biskupsdæmi 	 Biskupsdæmið
taínóindíána 	 Taínóindíána
Forsætisráðuneyti 	 Forsætisráðuneytið
Forsætisráðuneytið 	 Forsætisráðuneyti
Forsætisráðuneyti 	 Forsætisráðuneytið
Forsætisráðuneytið 	 Forsætisráðuneyti
Hebreska 	 hebreska
stafróið 	 stafrófið
hebreska 	 Hebreska
Samanstendur 	 samanstendur
tal 	 tal-
fornnorðurskautssvæðis 	 fornnorðurskautssvæðisins
rússnesksovétisk 	 rússnesk-sovésk
Norðurrín-Vestfalen 	 Norðurrín-Vestfalía
Samkynheigðir 	 Samkynhneigðir
samkynheigðar 	 samkynhneigðar
Stuttnefjan 	 Stuttnefja
Titanía 	 Títanía
Títaníu 	 Títanía
örgjörfinn 	 örgjörvinn
Amerísk-Kanadískur 	 amerísk-kanadískur
Borgarskipulagning 	 Borgarskipulag
miðvitaða 	 meðvitaða
marglyttutegund 	 marglyttutegundin
Demotex 	 Demodex
ætthvísl 	 ættkvísl
Curculionidae 	 Curculioninae
Stórkornótt 	 stórkornótt
Steinrunnin 	 Steinrunninn
loftlagsfræðingum 	 loftslagsfræðingum
Steinrunnin 	 Steinrunninn
loftlagsfræðingum 	 loftslagsfræðingum
hugspeki 	 Hugspeki
felstir 	 flestir
kveikara 	 kveikjara
Gyðingar 	 gyðingar
náttúnni 	 náttúrunni
númmer 	 númer
Eystrarsaltsríkjunum 	 Eystrasaltsríkjunum
Lund 	 Lunds
Lunds 	 Lund
Þorgerisfirði 	 Þorgeirsfirði
fjárfestingabanki 	 Fjárfestingabanki
þemulagið 	 þemalagið
munaðarleysingjahæli 	 munaðaleysingjahæli
myndasöguasería 	 myndasögusería
Alucard 	 Alucards
veturnar 	 veturna
Slímkolans 	 slímkolans
Sveitablöð 	 sveitarblöð
Nimravinae 	 nimravinae
Machairodontinae 	 machairodontinae
hlosen 	 holosen
landsisn 	 landsins
vestmannaeyjum 	 Vestmannaeyjum
músíktilraunir 	 Músíktilraunir
Bandarísk 	 bandarísk
framhja 	 framhjá
Vatikaninu 	 Vatíkaninu
eftirtaldir 	 Eftirtaldir
Vatnstúrbína 	 vatnstúrbína
Evrasísk 	 evrasísk
Rússneska 	 rússneska
uppgripaheyskapir 	 uppgripaheyskapur
annararri 	 annarri
íþróttavöllurinn 	 Íþróttavöllurinn
Þorsklifur 	 þorskalifur
þorskalýsi 	 Þorskalýsi
Konungulegu 	 Konungulega
Frankfúrt 	 Frankfurt
Botneðju 	 Botnleðju
leucophelbeia 	 leucophlebia
engjaskófaætt 	 engjaskófarætt
engjaskófaætt 	 engjaskófa
Anakondan 	 anakondan
hjálmaskyldu 	 hjálmaskyldan
Menntaskóla 	 Menntaskólanum
málfræði 	 Málfræði
Norðursfólk 	 Norðurfólk
Marrion 	 Marrions
Branham 	 Branhams
grasætt 	 grasaætt
karlkyns 	 Karlkyns
fundist 	 Fundist
Purkhólahraun 	 Purkhólahrauni
Adygeyska 	 adygeyska
адыгэбзэ 	 Aдыгэбзэ
Russlandi 	 Rússlandi
ran 	 rann
Astekar 	 astekar
astekar 	 Astekar
Asturias 	 Asturies
Asturies 	 Asturias
al-Amarnah 	 el-Amarnah
Makrílinn 	 makrílinn
Fræðiheiti 	 fræðiheiti
Efnahagsbrotadeildar 	 Efnahagsbrotadeild
eiðilagðist 	 eyðilagðist
Hringvegurinn 	 hringvegurinn
aktívismi 	 aktífismi
Fjörunni 	 fjörunni
dómstol 	 dómstól
Prinsinn 	 prinsinn
Feril 	 Ferill
endsneyti 	 eldsneyti
endurnýtanlegir 	 endurnýtanlegri
kvikmyndaverðlaununun 	 kvikmyndaverðlaununum
útvöxutrinn 	 útvöxturinn
fræum 	 fræjum
fræum 	 fræjum
Jarðarinnar 	 jarðarinnar
hinns 	 hins
hanns 	 hans
leiklistaskóla 	 leiklistarskóla
Ayobamþele 	 Ayobambele
continued 	 Continued
astronomy 	 Astronomy
probability 	 Probability
Randomness 	 andomness
miðborg 	 Miðborg
iðnbyltinginni 	 iðnbyltingunni
Skýjakljúfur 	 skýjakljúfur
Oktavíu 	 Octavíu
íslendingar 	 Íslendingar
Northwestern-háskóli 	 Northwestern-háskólann
norðsins 	 norðursins
borgarvikri 	 borgarvirki
Einstaklingur 	 einstaklingur
Vísindaheimspeki 	 vísindaheimspeki
zand-konungsættinni 	 Zand-konungsættinni
þrjatíu 	 þrjátíu
Skáldagáfa 	 Skáldgáfa
Líkaminn 	 Líkami
rokksveirarinnar 	 rokksveitarinnar
Öldungarnir 	 öldungarnir
þriggja 	 Þriggja
Vestur-Midhéruð 	 Vestur-Miðhéruð
Hip 	 Hipp
aðstoðu 	 aðstöðu
einstaklingir 	 einstaklingar
Moltkes 	 Moltke
Antoon 	 Anton
Anthonis 	 Anthonie
Anthonie 	 Anthonis
Anton 	 Antoon
aðlasöguhetjuna 	 aðalsöguhetjuna
rannsóknarlögregluforingjan 	 rannsóknarlögregluforingjann
Náttúran 	 náttúran
Sérhljóð 	 sérhljóð
einhljóð 	 Einhljóð
Norðurlandaráðs 	 Norðurlandaráðsþingi
Norðurlandaráðs 	 Norðurlandaráðsþingi
Norðurlandaráðs 	 Norðurlandaráðsþingi
Norðurlandaráðs 	 Norðurlandaráðsþingi
Ritaskrá 	 Ritskrá
sérstk 	 sérstak
Jasisma 	 jasisma
ruminantia 	 Ruminantia
ástró-asísku 	 ástróasísku
lífstíl 	 lífsstíll
Montreal 	 Montréal
Algonkíska 	 algonkínska
íslensku 	 Íslensku
Heimsminjaskrá 	 heimsminjaskrá
sjálfmorð 	 sjálfsmorð
norður-Ítalíu 	 Norður-Ítalíu
Pyreneafjöllum 	 Pýreneafjöllum
yfileitt 	 yfirleitt
Vilníus 	 Vilnius
Stundaði 	 stundaði
Sírakjús-héraði 	 Sýrakúsu-héraði
Helsingborg 	 Helsingborgs
sjálfsdáðun 	 sjálfsdáðum
þar 	 ‚þar
leiðir 	 leiðir‘
Santíago 	 Santíagó
Dímítríj 	 Dmítríj
Dímítrívítsj 	 Dmítríjevítsj
Sjostakovítsj 	 Shostakovítsj
Kanaríeyja 	 Kanaríeyjan
Youtube 	 YouTube
Flughræðlsa 	 Flughræðsla
Fromage 	 fromage
fromage 	 Fromage
norður-Frakklandi 	 Norður-Frakklandi
liturinnn 	 liturinn
liturinn 	 liturinnn
Flughræðlsa 	 Flughræðsla
Fromage 	 fromage
fromage 	 Fromage
norður-Frakklandi 	 Norður-Frakklandi
liturinnn 	 liturinn
liturinn 	 liturinnn
Suður-Sandvíkureyja 	 Suður-Sandvíkureyju
Helóodóros 	 Helíodóros
Atlandshafsins 	 Atlantshafsins
hvenkynshirslur 	 kvenkynshirslur
byrjarði 	 byrjaði
Listahátíð 	 listahátíð
listahátíð 	 Listahátíð
byrkningar 	 byrkninga
hanns 	 hann
sítronusafa 	 sítrónusafa
Messías 	 messías
Finlandi 	 Finnlandi
Norður-svæðið 	 Norðursvæðið
Ofurmáni 	 ofurmáni
Phenakistiscope 	 phenakistiscope
Atvinnulífsins 	 atvinnulífsins
sunnarverðan 	 sunnanverðan
Tókíóborgar 	 Tókýóborgar
Tónlistarmenn 	 tónlistarmenn
landbúnaðir 	 landbúnaði
mynnni 	 mynni
þeramínsins 	 þeremínsins
niflheims 	 Niflheims
múspelsheims 	 Múspellsheims
ginnungagapi 	 Ginnungagapi
íslandsmeistari 	 Íslandsmeistari
framsækið 	 Framsækið
framsækið 	 Framsækið
Golfklúbbur 	 golfklúbbur
golfklúbbur 	 Golfklúbbur
osturinn 	 Osturinn
Íslenskrar 	 íslenskrar
framleiðlan 	 framleiðslan
danmörku 	 Danmörku
danmörku 	 Danmörku
Húsamús 	 Húsamúsin
ecaudatuser 	 ecaudatus
suðaustur-Asíu 	 Suðaustur-Asíu
ersyðsti 	 syðsti
Senega 	 Senegal
Óleksíjóvitsj 	 Ólexíjóvitsj
vatnskenndari 	 vatnskendari
Kvendýrin 	 Kvendýrið
cleveland 	 Cleveland
ísafjarðardjúp 	 Ísafjarðardjúpi
Leucorhoa 	 leucorhoa
pípunefjaætt 	 pípunefja
litaafbrygði 	 litaafbrigði
hanns 	 hann
hanns 	 hans
Þekktast 	 þekktast
Fræðiheiti 	 fræðiheiti
solandrianaer 	 solandriana
leiðtogaskóli 	 leiðtogaháskóli
Benedictus 	 Benedict
Benedict 	 Benedictus
slíðrastör 	 slíðrastörin
slíðrastörin 	 slíðrastör
útsláttakeppni 	 útsláttarkeppni
Napoleon 	 Napóleon
sóleyjarætt 	 sóleyjaætt
bókfell 	 Bókfell
fortress 	 Fortress
Gráðostar 	 gráðostar
gráðostar 	 Gráðostar
kassagítarar 	 hálfkassagítarar
hálfkassagítarar 	 kassagítarar
höfuðbói 	 höfuðbólið
heimvöllur 	 heimavöllur
Collage 	 College
yðkaðar 	 iðkaðar
parabolic 	 Parabolic
probability 	 Probability
trajectory 	 Trajectory
Magistergráðu 	 magistergráðu
míníósk 	 mínóísk
stróksins 	 stróksinns
Shippuuden 	 Shippudden
Neytendasamtök 	 Neytendasamtökin
Sígaunar 	 sígaunar
sikileyjarvarnar 	 Sikileyjarvarnar
undilagi 	 undirlagi
hófus 	 hófust
Spurningakeppni 	 spurningakeppni
spurningakeppni 	 Spurningakeppni
sveitarfélafinu 	 sveitarfélaginu
matvælafyrirtæki 	 Matvælafyrirtæki
Masóvía-hérað 	 Masóvía-héraði
tímagreinda 	 tímagreindri
háskólanum 	 Háskólanum
Vili 	 Vilji
óendurnýtanleg 	 óendurnýjanleg
danmerkur 	 Danmerkur
niflheims 	 Niflheims
múspelsheims 	 Múspellsheims
ginnungagapi 	 Ginnungagapi
Vietnam 	 Víetnam
gítarleikarinn 	 Gítarleikarinn
professor 	 prófessor
hvílftarjökuls 	 hvilftarjökuls
Ármótakvíslúr 	 Ármótakvísl
austurasísk 	 austur-asísk
przewalskii 	 Przewalski
hestasætt 	 hestaætt
RKS 	 mRKS
RKS 	 rRKS
RKS 	 tRKS
RKS 	 mRKS
RKS 	 rRKS
RKS 	 tRKS
RKS 	 mRKS
RKS 	 rRKS
RKS 	 tRKS
RKS 	 mRKS
RKS 	 rRKS
RKS 	 tRKS
Slagæðar 	 Slagæð
rúmmali 	 rúmmáli
hljómsveitarinnar 	 rokk-hljómsveitarinnar
álmategundin 	 álmtegundin
Ålandsk 	 Åländsk
Alþjóðagjaldeyrissjóðurnum 	 Alþjóðagjaldeyrissjóðnum
Gyðinga 	 gyðinga
kýrillíska 	 kýrillísku
misti 	 missti
Bandaríkja 	 Bandaríkjanna
Bliss-táknkerfið 	 Blisstáknkerfið
Boulders 	 Boulder
Brjánslækur 	 Brjámslækur
kaffidrykkkur 	 kaffidrykkur
O´Donnell 	 ODonnell
sámfélögum 	 samfélögum
Bronislaw 	 Bronisław
siðaskifti 	 siðaskipti
siðaskifti 	 siðaskipti
miðjarðahafs 	 miðjarðahafslönd
aðlagsta 	 aðlagast
Kampaníu 	 Kampanía
Napólíflóa 	 Napolíflóa
næstærsta 	 næststærsta
Heimspeki 	 heimspeki
Mennstaskólanum 	 Menntaskólanum
afstöuð 	 afstöðu
rekstur 	 Rekstur
Bogkrabbi 	 bogkrabbi
Listasafn 	 listasafn
listasafn 	 Listasafn
Geimgemgill 	 Geimgengill
suð-suðvestur 	 suðsuðvestur
malinka 	 maninka
maninka 	 malinka
laga 	 laga-
Kellogg´s 	 Kelloggs
Jörðina 	 jörðina
Neanderdalsmenn 	 neanderdalsmenn
Neanderdalsmenn 	 neanderdalsmenn
vopnagerð 	 vopnagerðar
Noether 	 Noethers
Fjármálaráðherra 	 fjármálaráðherra
paracetamóls 	 parasetamóls
Portúgalskt 	 Portúglska
löggjafavalds 	 löggjafarvalds
skipsflök 	 Skipsflök
skydeforening 	 Skydeforening
skólabókasöfn 	 Skólabókasöfn
Dale 	 Dal
Hagenbeck 	 Hagenbecks
dýragarður 	 Dýragarður
breytingar 	 Breytingar
Verundir 	 Verund
Algengur 	 algengur
rómverjar 	 Rómverjar
okkars 	 okkar
reitmynstri 	 reitamynstri
aristo 	 aristo-
Belgrad 	 Beograd
Beograd 	 Belgrad
heimstyrjöldinni 	 heimsstyrjöldinni
Coritiba 	 Curitiba
Coritiba 	 Curitiba
Curitiba 	 Coritiba
WBush 	 Bush
Dímeþýkjvikasilfur 	 Dímetýlkvikasilfur
austurátt 	 suðausturátt
einig 	 einnig
fánin 	 fáninn
fánin 	 fáni
austurátt 	 suðausturátt
einig 	 einnig
fánin 	 fáninn
fánin 	 fáni
fjölgervisform 	 fjölgervingsformum
fluttninga 	 flutninga
útirauðsmýri 	 Útirauðsmýri
Krúnuborgarhöll 	 Krónborgarhöll
flugvellum 	 flugvellinum
flugvellum 	 flugvöllum
Malukæyjum 	 Malukueyjum
Rússnesku 	 rússnesku
Alþjóðaríkisborgararéttur 	 þjóðríkisborgararéttur
þjóðríkisborgararéttur 	 Alþjóðaríkisborgararéttur
bandríkjunum 	 Bandríkjunum
meginn 	 megin
Svignalúslús 	 Svignalús
Ferskavatnsfiskur 	 ferskvatnsfiskur
Urðarbrunnur 	 Urðarbrunn
jiu-jitsu 	 jiu-jitsui
stæsta 	 stærsta
Evrýsteifs 	 Evrýsþeifs
Hugsanlegar 	 Hugsanleg
atburðarásir 	 atburðarás
Myslnubökur 	 Mylsnubökur
O´Donnell 	 ODonnell
Columbiu 	 Columbia
dýrsfrumum 	 dýrafrumum
leyndarsómsfulla 	 leyndardómsfulla
Ellyar 	 Ellyjar
embæti 	 embætti
felmsturskast 	 felmturskast
Fosfólípið 	 Fosfólípíð
sisters 	 Sisters
Tegundarheitið 	 tegundarheitið
felmsturskast 	 felmturskast
Fosfólípið 	 Fosfólípíð
sisters 	 Sisters
Tegundarheitið 	 tegundarheitið
Regulus 	 regulus
regulus 	 Regulus
aðalspraut 	 aðalsprauta
trjáum 	 trjám
norð-vestri 	 norðvestri
drungarokkshljómsveit 	 svartþungarokkshljómsveit
Norðanverðum 	 norðanverðum
Hobbiter 	 Hobbit
Hobbiter 	 Hobbit
Kentárs 	 kentárs
japaninn 	 Japaninn
aðalega 	 aðallega
Leiklist 	 leiklist
austur 	 austur-
Bookstore 	 Bookstoreár
vigurstæðr 	 vigurstærð
svahílí 	 Svahílí
Gulusótt 	 gulusótt
Paclitaxel 	 paclitaxel
Tröllakrabbanum 	 tröllakrabbanum
Maíkonungurinn 	 maíkonungurinn
Útbreiddur 	 Útbreidd
Þokkagyðjunum 	 þokkagyðjunum
akkadíska 	 Akkadíska
Forfaðir 	 forfaðir
Burstormar 	 Burstaormar
nátturuleg 	 náttúruleg
Flestu 	 Flest
Botswana 	 Botsvana
Suður 	 Suður-
Halldórr 	 Halldór
Mjóvafjörð 	 Mjóafjörð
Íslensk 	 íslensk
Barthólomeusarvígunum 	 Bartólómeusarvígunum
frumefnaformi 	 frumefnisformið
Kandela 	 candela
Candela 	 Kandela
Candela 	 candela
þektastir 	 þekktastir
tröllkonuna 	 tröllkonuni
Angurboðu 	 Angurböðu
Lúðrasveit 	 lúðrasveit
Íslensk 	 íslensk
Lúðrasveit 	 lúðrasveit
sjónvarps 	 sjónvarps-
brátskráða 	 brautskráða
salentó-skagi 	 Salentó-skagi
ítalíuskaga 	 Ítalíuskaga
feriðir 	 ferðir
norður 	 norður-
Smithsonian-dýragarðurinn 	 Smithson-dýragarðurinn
félagskordýr 	 félagsskordýr
Portúgalir 	 Portúgalar
Blettakarfan 	 blettakarfan
Svartþorskur 	 svartþorskur
Búrhvalir 	 búrhvalir
Kyrrahafslúða 	 kyrrahafslúða
minnuhlutamál 	 minnihlutamál
Elli 	 Ellie
Flauels-djass 	 Flauelsdjass
kalksteinaklettar 	 kalksteinakletta
Frumeindunum 	 Frumefnunum
bráðklárir 	 bráðklárar
Mann-ers 	 Manners
Formentera 	 Forminterra
Kelta 	 Keltar
tvent 	 tvennt
Mann-ers 	 Manners
Formentera 	 Forminterra
Kelta 	 Keltar
tvent 	 tvennt
mosfellsbæ 	 Mosfellsbæ
p-efnis 	 n-efnis
n-efnis 	 p-efnis
Háskóli 	 Háskólinn
Suðvestur-Englandi 	 Suðaustur-Englandi
Heródótusar 	 Heródótosar
Hoffmann 	 Hofmann
þeira 	 þeirra
banana 	 banana-
Vikernis 	 Vikernes
Hippokrates 	 Hippókrates
íslandslýsing 	 Íslandslýsing
Paleógentímabilið 	 paleósentímabilið
Paleósentímabilið 	 Paleógentímabilið
Paleósentímabilið 	 paleósentímabilið
Paleósentímabilið 	 eósentímabilið
Eósentímabilið 	 eósentímabilið
Ólígósentímabilið 	 ólígósentímabilið
tiltörulega 	 tiltölulega
Skrælingjaey 	 Skrælingjaeyja
Skrælingjaeyja 	 Skrælingjaey
kjarnakrftanna 	 kjarnakraftanna
Eðlisfræðingar 	 eðlisfræðingar
ítalska-abbesíska 	 ítalsk-abbesíska
áreyrym 	 áreyrum
breytingar 	 Breytingar
Athyglin 	 Athygli
Dómkirkja 	 Dómkirkjan
Dómkirkja 	 dómkirkja
Dómkirkja 	 Dómkirkjan
Dómkirkja 	 dómkirkja
Convent 	 Covent
Covent 	 Convent
formerkisfalli 	 formerkisfallsins
formerkisfalli 	 formerkisfallsins
Garðabobba 	 garðabobba
Gjallgígur 	 Gjallgígar
farstótt 	 farsótt
Hugrænt 	 hugrænt
Cognitive 	 cognitive
Depression 	 depression
maríneringuna 	 maríneringunni
frægðin 	 Frægðin
skildur 	 skyldur
brennsistein 	 brennisteini
Han 	 Hann
skiftist 	 skiptist
Súmerska 	 Súmera
Súmerska 	 súmerska
Fornleifafræðinga 	 Fornleifafræðingar
Þjóðskjalavarðar 	 þjóðskjalavarðar
Tunrinn 	 Turninn
óneitnalega 	 óneitanlega
vestur-Evrópu 	 Vestur-Evrópu
Benntts 	 Bennetts
King´s 	 Kings
hljómsveit 	 Hljómsveit
Eðalkarpi 	 Eðalkarpinn
Endurreisnartímanum 	 endurreisnartímanum
Frenzyo 	 Frenzy
þrfnast 	 þarfnast
þrfnast 	 þarfnast
Japanskur 	 japanskur
Sjónvarpsframleiðandi 	 sjónvarpsframleiðandi
Sjónvörp 	 sjónvörp
Landssambandi 	 Landssambands
Endurreisnartímanum 	 endurreisnartímanum
Frenzyo 	 Frenzy
þrfnast 	 þarfnast
þrfnast 	 þarfnast
Japanskur 	 japanskur
Sjónvarpsframleiðandi 	 sjónvarpsframleiðandi
Sjónvörp 	 sjónvörp
Landssambandi 	 Landssambands
Galíleó 	 Galílei
Galílei 	 Galíleó
paleó-síberískra 	 paleósíberískra
bandvefsjúpur 	 bandvefshjúpur
Gresjufílar 	 gresjufílar
dreyfist 	 dreifist
Hómelíubók 	 Hómilíubók
Indipendent 	 Independent
Koparreynis 	 Koparreynir
Hersegóvinu 	 Hersegóvínu
Boyles 	 Boyle
lögmálí 	 lögmál
Boyle 	 Boyles
þáttakendur 	 þátttakendur
Nestoríusi 	 Nestoríosi
Cumacea 	 cumacea
brinjuna 	 brynjuna
vopninn 	 vopnin
Samstepya 	 Samsteypa
bigalowii 	 bigelowii
pólýesteraþráðum 	 pólýesterþráðum
Súrinam 	 Súrínam
Tékkenska 	 Tékknеska
svart-tungu 	 svarttungu
hreyðrar 	 hreiðrar
allann 	 allan
grimd 	 grimmd
grönnnum 	 grönnum
Twice´ 	 Twice
suðvedurhluta 	 suðvesturhluta
Laktósi 	 laktósi
liðmót 	 liðamót
konungsdómsins 	 konungdómsins
Kastilçia-La 	 Kastilía-La
sjóin 	 sjóinn
Bandarískt 	 bandarískt
Limbourgh 	 Limburg
Limburg 	 Limbourgh
Sínaískaginn 	 Sínaí-skagi
Baltneskri 	 baltneskri
Wight-eyju 	 Wighteyju
Stundaði 	 stundaði
síldarminjarsafnið 	 Síldarminjasafnið
karkyns 	 karlkyns
biskupsstolnum 	 biskupsstólnum
Skalholti 	 Skálholti
boroðað 	 borðað
dótturinn 	 dótturina
Claudius 	 Claudíus
Döðluplómur 	 döðluplómur
áEigilsstöðum 	 Egilsstöðum
ósírisi 	 Ósírisi
egyptalands 	 Egyptalands
Xenofanes 	 Xenófanes
svingómýelín 	 sfingómýelín
Xenofanes 	 Xenófanes
svingómýelín 	 sfingómýelín
sellúósa 	 selluósa
Kvikmyndastjórn 	 kvikmyndastjórn
Lirfunni 	 lirfunni
einsleitnari 	 einsleitari
Geobbels 	 Goebbels
Kalvínistum 	 kalvínistum
Lækjatorgi 	 Lækjartorgi
Trojustríðið 	 Trójustríðið
jafnframa 	 jafnframt
Eistneska 	 eistneska
Lincon 	 Lincoln
Oxalsýra 	 Oxalsýru
Cephenomyia 	 Cephenemyia
Gaulveja 	 Gaulverja
Stafkirkja 	 stafakirkja
stafakirkja 	 Stafkirkja
httpwwwbacteriocictfrList 	 httpwwwbacteriocictfr
staðsetningatalnakerfi 	 staðsetningatáknakerfi
Vesturfararnir 	 Vesturfarar
tilfiðrildafræðanna 	 fiðrildafræðanna
Þrúðvangar 	 Þrúðvangur
tímarítinu 	 tímaritinu
þrepeimingu 	 þrepaeimingu
forsætisráðherran 	 forsætisráðherrann
sjónvarps 	 sjónvarps-
Tórontó 	 Torontó
ontaríó 	 Ontaríó
Digimon 	 Digimonar
Höfuðstödvar 	 Höfuðstöðvar
breyddar 	 breiddar
Stundum 	 stundum
problem 	 Problem
Stundum 	 stundum
problem 	 Problem
foreldrar 	 Foreldrar
Koch-bræðurnar 	 Koch-bræðurna
lagnavalis 	 Lagnavalis
þýttbýlissvæði 	 þéttbýlissvæði
þéttbýlissvæði 	 þýttbýlissvæði
Limbourgh 	 Limburg
Limburg 	 Limbourgh
landssvæði 	 landsvæði
sæðisfræum 	 sæðisfrumum
mið-Afríku 	 Mið-Afríku
Mykines 	 Mykiness
sístaða 	 Sístaða
ungmennafélag 	 Ungmennafélagið
Norður-ameríku 	 Norður-Ameríku
ísraelskru 	 ísraelsku
borgarinnar 	 Borgarinnar
Grasagarður 	 Grasagarðurinn
Ýmiss 	 Ýmis
tónlistarstefnu 	 tónlistarstefna
þyrniættkvísl 	 þyrnaættkvísl
Khant 	 Khanta
Evenk 	 Evenka
Ijsselmeer 	 IJsselmeer
Vafhafið 	 Vaðhafið
Háskóla 	 Háskólann
Klemens 	 Clemens
Clemens 	 Klemens
viðsvegar 	 víðsvegar
Afrískum 	 afrískum
Náttúra 	 Náttúru
nýnorskunar 	 nýnorskunnar
Oostende 	 Ostende
Ostende 	 Oostende
Ostende 	 Oostende
Eningin 	 Einingin
Díonysosar 	 Díonýsosar
marglituð 	 marglit
Neðanjarðarlest 	 neðanjarðarlest
Vanalega 	 vanalega
hreinsað 	 Hreinsað
Sófista 	 sófista
tetroninn 	 tertoninn
Tereshkova 	 Teresjkova
félagslega- 	 félagslega
Leonide 	 Leopnide
Omettuð 	 Ómettuð
sí-smækkandi 	 sísmækkandi
laggður 	 lagður
flugfélag 	 flugfélagum
flugfélagum 	 flugfélag
barna 	 barna-
Terreblanche 	 TerreBlanche
ferningfylki 	 ferningsfylki
ferningfylki 	 ferningsfylki
Irmingerhafi 	 Irmingerhafs
Jökulsstaðir 	 Jökulsstaði
Limburgi 	 Limburg
hansakaupmanna 	 Hansakaupmanna
danaveldis 	 Danaveldis
margliða 	 margliðan
margliðan 	 margliða
merinófé 	 Merinófé
Montreal 	 Montréal
Swahili 	 swahili
Navajó 	 Navajói
Navajóa 	 Navajói
Fyirtækið 	 Fyrirtækið
Ohrmuzd 	 Ohrmazd
Ohrmazd 	 Ohrmuzd
Japanska 	 japanska
grófrt 	 gróft
Árás 	 Árása
stofnbrota 	 stofnbrot
stofnbrot 	 stofnbrota
Tækniháskólinn 	 Tækniháskólans
Labor 	 Labour
Cambridgeháskóla 	 Cambridge-háskóla
meða 	 með
sutján 	 sautján
↓blóðþrýstingur→ 	 ↑blóðþrýstingur→
↑blóðþrýstingur→ 	 ↓blóðþrýstingur→
súðavíkurvegi 	 Súðavíkurvegi
Augabrúnir 	 augnabrúnir
mannsugu 	 mannsaugu
Barrskógabelti 	 Barrskógabeltið
barrté 	 barrtré
vatnsaflvirkjun 	 vatnsaflsvirkjun
aðalega 	 aðallega
hefðbundin 	 óhefðbundin
óhefðbundin 	 hefðbundin
Hallinn 	 Halinn
nítróglyserín 	 nítróglyseríns
Elliðaárvatn 	 Elliðavatn
aðilaríki 	 aðildarríki
Seðablanka 	 Seðlabanka
bókasögn 	 bókasöfn
fréttir 	 Fréttir
upplisingar 	 upplýsingar
fangelsistilraunin 	 fangelsistilraun
bókasögn 	 bókasöfn
fréttir 	 Fréttir
upplisingar 	 upplýsingar
fangelsistilraunin 	 fangelsistilraun
Hogwarts 	 Hogwart
réttvísinnar 	 Réttvísinnar
Hlaupum 	 hlaupum
Hornsílið 	 hornsílið
hornsílið 	 Hornsílið
threespice 	 threespine
hreindýrir 	 hreindýrin
leitogi 	 leiðtogi
skreitt 	 skreytt
Madeiraeyju 	 Madeiraeyjum
Basil 	 Basils
Mírkónesía 	 Míkrónesía
Menningu 	 menningu
Breskra 	 breskra
Bandarískra 	 bandarískra
sendinefdn 	 sendinefnd
rétttrúnaðarkirkjan 	 Rétttrúnaðarkirkjan
Skeljaröðun 	 skeljaröðun
Sófistar 	 sófistar
Televisoin 	 Television
hexacorallia 	 hexacorallia-ætt
hljóðupökur 	 hljóðupptökur
ófyrirjáanlegur 	 ófyrirsjáanlegt
melodíum 	 melódíum
populus 	 Populus
populus 	 Populus
ákjósanlegt 	 Ákjósanlegt
Markaður 	 markaður
Markaður 	 markaður
Engjasnigilsætt 	 engjasnigilsætt
leiksskóla 	 leikskóla
þáttaröðina 	 þáttaröðinni
leiksskóla 	 leikskóla
þáttaröðina 	 þáttaröðinni
Grendels 	 Grendils
ljósleiðaranet 	 ljósleiðaraneti
Fyrst 	 Fyrstu
Athabaskan 	 Atabaska
pseudo-random 	 Pseudo-random
Pantomime 	 pantomime
látbragðsleikur 	 Látbragðsleikur
nærststærstu 	 næststærstu
Rastafarianism 	 rastafarianismi
Skírnisstærð 	 skírnisstærð
Dufann 	 Dufan
Síkismi 	 Síkhismi
edru 	 eru
edru 	 eru
aðalega 	 aðallega
Íslenskra 	 íslenskra
mánuðir 	 Útmánuðir
Persneska 	 persneska
Alþýðileg 	 Alþýðuleg
áflogslínuna 	 áflogalínuna
aðalbláæðir 	 aðalbláæðar
bakeríi 	 bakaríi
búddhahof 	 búddahof
evanlísk-lúthersku 	 evangelísk-lúthersku
fjlótinu 	 fljótinu
höfðinn 	 Höfðinn
djasse 	 djass
Piemont 	 Piemonte
Piemont 	 Piémont
Piemonte 	 Piemont
Piedmont 	 Piemont
Piedmont 	 Piemonte
Himininn 	 himininn
Piemont 	 Piemonte
Piemont 	 Piémont
Piemonte 	 Piemont
Piedmont 	 Piemont
Piedmont 	 Piemonte
Himininn 	 himininn
Almennt 	 almennt
Túnfiskur 	 túnfiskur
Túnfiskur 	 túnfiskur
Botnvarpa 	 botnvarpa
Trykjaráninu 	 Tyrkjaráninu
hljómsveitir 	 indíhljómsveitir
Sykursýki 	 sykursýki
Grenjaðastaðakirkju 	 Grenjaðarstaðarkirkju
kvikarsilfur 	 kvikasilfur
tendur 	 stendur
íraks 	 írak
Prinsessa 	 prinsessa
Nestoríus 	 Nestoríos
steingerfingi 	 steingervingi
júgólslavnesku 	 júgóslavnesku
oftas 	 oftast
Samsteypustjórn 	 samsteypustjórn
Jafnigildi 	 Jafngildi
Rökrásir 	 Rökrás
Stundagyðjurnar 	 stundagyðjurnar
Suður-Þingejarsýsla 	 Suður-Þingeyjarsýsla
taknmálið 	 táknmálið
Yggldrasils 	 Yggdrasils
akavajo 	 Akavajo
Venesúelu 	 Venesúela
storkubergfræði 	 storkubergsfræði
myndbreytingarbergfræði 	 myndbreytingarbergsfræði
setbergfræði 	 setbergsfræði
Dyflinarsýsla 	 Dyflinnarsýsla
Sjaldgæft 	 sjaldgæft
hagsvöxtur 	 hagvöxtur
hundruða 	 hundraða
Eðalkarpan 	 Eðalkarpann
Mið-perskneska 	 miðperskneska
perskneska 	 miðperskneska
Fornpersnesku 	 fornpersnesku
upphafslandi 	 upphafslandinu
loðréttum 	 lóðréttum
Mið-perskneska 	 miðperskneska
perskneska 	 miðperskneska
Fornpersnesku 	 fornpersnesku
upphafslandi 	 upphafslandinu
loðréttum 	 lóðréttum
Stúdent 	 stúdent
Fjölbrautarskólanum 	 Fjölbrautaskólanum
Stjórnmálafræðingur 	 stjórnmálafræðingur
Karldýrin 	 Karldýrið
Stundaði 	 stundaði
skólnn 	 skólann
Karpatíufjöll 	 Karpatafjöll
málmfilmu 	 málmfilma
Venjulega 	 venjulega
Melagræða 	 Melakræða
gruithttpsenwikipediaorgwikiGruit 	 httpsenwikipediaorgwikiGruit
gómfillan 	 gómfyllan
Wikipedia 	 Wikipediu
danmerkur 	 Danmerkur
þýskalands 	 Þýskalands
Bandaríkjin 	 Bandaríkin
Plötusnúður 	 plötusnúður
Skemmtistaðnum 	 skemmtistaðnum
Verkfæri 	 verkfæri
Teletext 	 teletext
arvaníska 	 Arvaníska
Gríkklandi 	 Grikklandi
mið 	 mið-
Fimmund 	 fimmund
fimmund 	 Fimmund
Vesturnorrænt 	 vesturnorrænt
Fimmund 	 fimmund
fimmund 	 Fimmund
Vesturnorrænt 	 vesturnorrænt
Rhódos 	 Ródos
gamlann 	 gamlan
november 	 nóvember
menntagyðjurnar 	 Menntagyðjurnar
rómaveldis 	 Rómaveldis
Ondarroa 	 Ondárroa
Ondárroa 	 Ondarroa
Norðurpólinn 	 norðurpólinn
Hanover 	 Hannover
Sextánundarkerfi 	 Sextánundakerfi
Frjógvun 	 Frjóvgun
stundum 	 Stundum
fræðiheiti 	 Fræðiheiti
Tékkneska 	 tékkneska
Indóevrópskt 	 indóevrópskt
vestur-slavneskra 	 vesturslavneskra
tabuilforme 	 tabuliforme
Baldurrson 	 Baldurson
alemanníska 	 Alemanníska
alemanníska 	 alemannísku
germanskt 	 Germanskt
indóevrópskt 	 Indóevrópskt
Einsteins 	 Einstein
Starfsemiskenning 	 starfsemiskenning
Eft­ir 	 Eftir
rit­verka 	 ritverk
leik­rit 	 leikrit
skáld­sög­ur 	 skáldsögur
þýðing­ar 	 þýðingar
debitkort 	 debetkort
tónlistarstefnu 	 tónlistarstefna
Lagarfljóts 	 Lagarfljótsbrú
Lagarfljótsbrú 	 Lagarfljóts
Heimsmiðstöð 	 heimsmiðstöð
Baáí 	 Baháí
Gralinn 	 gralinn
gralurinn 	 gralinn
gralinn 	 Gralinn
gralinn 	 grallinn
Skipulag 	 skipulag
jökular 	 jöklar
ljóstillífunarlagi 	 ljóstillífunarbelti
Guðs 	 Guð
Blómlaukurinn 	 Blómlaukur
þormóðsstaðaveg 	 Þormóðsstaðaveg
lýrufuglar 	 Lýrufuglar
milljarðasti 	 milljarðasta
nifteindaflutning 	 nifteindaflutningi
Pamír-fjöllum 	 Pamírfjöllum
Port 	 Pot
Pot 	 Port
Prestley 	 Presley
sjávarfalla-millur 	 sjávarfallamyllur
rithöfundin 	 rithöfundinn
leitogi 	 leiðtogi
úkraískaЗапоріжська 	 úkraískaЗапорізька
frásögn 	 Frásögn
áheyrslu 	 áherslu
Assameíska 	 Assamíska
Jónahafið 	 Jónahaf
Eyjahafið 	 Eyjahaf
flækingurinn 	 Flækingurinn
innihelda 	 innihalda
Equs 	 Equus
bygð 	 byggð
vefhreifimynd 	 vefhreyfimynd
bygð 	 byggð
vefhreifimynd 	 vefhreyfimynd
ólífu-grænt 	 ólífugrænt
Norður-Atlandshafi 	 Norður-Atlantshafi
Viðvíkurhrepps 	 Viðvíkurhreppi
stuðlaðj 	 stuðlað
Forleifafræðingar 	 Fornleifafræðingar
Kómódódraki 	 Kómódódreki
Skraparotsprédikun 	 Skraparotspredikun
Linköping 	 Linköpings
Linköping 	 Linköpings
Listasafn 	 Listasavn
Listasafn 	 listasafn
Listasavn 	 Listasafn
listasafn 	 Listasafn
færeyjum 	 Færeyjum
Hellarnir 	 hellarnir
fjárhellar 	 Fjárhellrar
Fjárhellrar 	 fjárhellar
menningarleg 	 Menningarleg
Möbiusfallsins 	 Möbiusarfallsins
ísraela 	 Ísraela
metylenbláu 	 metýlenbláu
fyrirlestrari 	 fyrirlesari
Stundaði 	 stundaði
propylaea 	 Propylaea
Propylaea 	 propylaea
Karldýrin 	 Karldýrið
trisopterus 	 Trisopterus
Upsílon 	 Ypsílon
evrópumótið 	 Evrópumótið
fjallsá 	 Fjallsá
ráðgajafarfyrirtæki 	 ráðgjafarfyrirtæki
Fjölbrautaskóli 	 fjölbrautaskóli
fjölbrautaskóli 	 Fjölbrautaskóli
Fuglafjörður 	 Fuglafjørður
Fuglafjørður 	 Fuglafjörður
Fjölbrautaskóli 	 fjölbrautaskóli
fjölbrautaskóli 	 Fjölbrautaskóli
Fuglafjörður 	 Fuglafjørður
Fuglafjørður 	 Fuglafjörður
Marsi 	 Mars
Kjetils 	 Ketils
Þórgunnuson 	 Þorgunnuson
jöfnurnar 	 Jöfnurnar
numbers 	 number´s
kinematics 	 Kinematics
n-dimensional 	 N-dimensional
strange 	 Strange
Bandaríkjana 	 Bandaríkjanna
grasafræðingnumw 	 grasafræðingnum
þjóðerninsímynd 	 þjóðernisímynd
norðmanna 	 Norðmanna
nokkuri 	 nokkurri
kindi 	 kindin
allmennt 	 almennt
tíbetsk 	 tíbesks
ónæmisfræðingi 	 ónæmisfræðingur
aklanska 	 Aklanska
Alkóhóls 	 alkóhóls
Chermesidae 	 Chermidae
Chermidae 	 Chermesidae
Borgarklassi 	 Borgaklasi
Dnjestr 	 Dnjester
Dnjester 	 Dnjestr
fræðiheiti 	 Fræðiheiti
Sjávarútvegs 	 sjávarútvegs
streyta 	 streita
fritillaria 	 Fritillaria
Dahomey 	 Dahómey
Sjávarútvegs 	 sjávarútvegs
streyta 	 streita
fritillaria 	 Fritillaria
Dahomey 	 Dahómey
geimferðaáætlunin 	 geimferðaáætlun
Mkhedruli 	 mkhedruli
fræðilega 	 Fræðilega
stjornum 	 stjórnum
Hippias 	 Hippías
Hippias 	 Hippiasar
kandidat 	 kandídat
Borgarastyrjöldini 	 borgarastyrjöldinni
Fræðiheiti 	 fræðiheiti
Kamsjatkaskaginn 	 Kamsjatkaskagi
árósina 	 árósana
sprengugígur 	 sprengigígur
kynjamismunum 	 kynjamismunun
Vernduð 	 vernduð
Paulusar-greinar 	 Paullusar-greinar
Paulusar 	 Paullusar
hryfnir 	 hrifnir
Henrik 	 Henri
Bandarísk 	 bandarísk
Erítrea 	 Eritrea
Norðurland 	 Norrland
landshlutur 	 landshluta
Hringadróttinssögueftir 	 Hringadróttinssögu
TolkienOg 	 Tolkien
Paracetamól 	 Parasetamól
Kierkegarrd 	 Kierkegaard
ströndu 	 strönd
d´Art 	 dArt
fögurri 	 fagurri
unhverfi 	 umhverfi
Kampaníu 	 Kampanía
Íslenskra 	 íslenskra
Skólalúðrasveita 	 skólalúðrasveita
Stanfurðubryggja 	 Stafnfurðubryggja
Stafnfurðubryggja 	 Stanfurðubryggja
Sófista 	 sófista
Flæmskur 	 flæmskur
ölpunum 	 Ölpunum
IS-LM-líkan 	 IS-LM-líkanið
auðigur 	 auðugur
Stundaði 	 stundaði
Tarkovskys 	 Tarkovskíjs
tónlistarstefnuna 	 Nova-tónlistarstefnuna
tónsmíðar 	 raftónsmíðar
yfirleit 	 yfirleitt
Menntaskólarnir 	 Menntaskólar
Мощеная 	 Мощена
Мощеная 	 Мощёная
fornöldum 	 fornöld
Pósturþjónusta 	 Póstþjónusta
kúarbjöllur 	 kúabjöllur
Evrasísk 	 evrasísk
Tölvunarfræði 	 tölvunarfræði
Ólympíuskísvæði 	 Ólympíuskíðasvæði
ryðfríðu 	 ryðfríu
áningastaður 	 áningarstaður
Guðmundsonar 	 Guðmundsson
shía 	 shíta
Ítalska 	 Ítalskt
Ítalska 	 ítalska
eftirtektaverðast 	 eftirtektarverðust
fjöggura 	 fjögurra
Cappuccino 	 cappuccino
svökölluðu 	 svokölluðu
Alexandria 	 Alexandriu
Hertford 	 Hereford
Hertfordshire 	 Herefordshire
Exocetflugskeytinu 	 Exocet-flugskeytinu
musterisriddurunum 	 Musterisriddurunum
musterisriddurunum 	 Musterisriddurunum
hólavallakirkjugarð 	 Hólavallakirkjugarð
Hebreska 	 hebreska
óhugnaðlega 	 óhugnanlega
Holdhnóska 	 Holdhnjóska
holdnúskur 	 holdhnúskar
áhugmál 	 áhugamál
Kjarnorkusprengja 	 Kjarnorkusprengjan
Kyrrabelti 	 Kyrrabeltið
Lífdísilolía 	 dísilolía
dísilolía 	 Lífdísilolía
Keplers 	 Kepler
Kepler 	 Keplers
Samningur 	 samningur
gyftast 	 giftast
Madonna 	 Madonnu
Vestur-Indíafélagið 	 Austur-Indíafélagið
nærststærst 	 næststærst
lanveitandi 	 lánveitandi
Sjovshoved 	 Skovshoved
Sjovshoved 	 Skovshoved
Sjovshoved 	 Skovshoved
snajllúr 	 snjallúr
kastilíanska 	 kastilíska
sveifjanleg 	 sveigjanleg
Niccolo 	 Niccolò
pop-rock 	 pop-rokk
þvagblöðruna 	 þvagblöðrunar
Kulborð 	 Kulborði
japanir 	 Japanir
Fersentimetri 	 Fersentímetri
Phthirus 	 Pthirus
Fersentimetri 	 Fersentímetri
Phthirus 	 Pthirus
aðkomustaður 	 viðkomustaður
Meðhandla 	 Meðhöndla
hjarastopp 	 hjartastopp
Kínahverfi 	 Kínahverfin
Wayn 	 Wayne
Cornell-háskólanum 	 Cornell-háskóla
Lievog 	 Lievogs
landsins 	 Landsins
Segulfræði 	 Segulflæði
Mindinni 	 Myndinni
kommúnistar 	 Kommúnistar
Leníns 	 Lenín
Næringarinntaka 	 Næringarinntakan
þanneig 	 þannig
handknattleiksdeildakerfið 	 karlahandknattleiksdeildakerfið
firstur 	 fyrstur
alþingiskosningum 	 Alþingiskosningum
landsvæði 	 landssvæði
rán-bjalla 	 ránbjalla
Fulltrúi 	 fulltrúi
liðsstjórnandinn 	 leikstjórnandinn
trúarljómann 	 trúarljóma
Einstaklingur 	 Einstaklingar
orðasafnsins 	 orðasafnsinu
karl 	 karl-
Ermasundseyjar 	 Ermarsundseyjar
samegilegra 	 sameiginlegra
Dúshanbe 	 Dúsjanbe
tadsjikíska 	 tadsikíska
Tadsjikistan 	 Tadsikistan
Johnathan 	 Jonathan
frjálsíþróttasamband 	 Frjálsíþróttasamband
frjálsíþróttasamband 	 Frjálsíþróttasamband
Ganglera 	 Gangleri
Túnfiskurinn 	 túnfiskurinn
rithöfundin 	 rithöfundinn
Hofsstaðapláss 	 Hofstaðapláss
Humlaætt 	 humlaætt
miðausturlanda 	 Miðausturlanda
clangula 	 Clangula
Isortoq 	 Isertoq
prófessór 	 prófessor
Katalónska 	 katalónska
katalónska 	 Katalónska
stórborgarsvæði 	 stórborgarsvæðið
suður-Grænlandi 	 Suður-Grænlandi
Chruchill 	 Churchill
kirtilvörturá 	 kirtilvörtur
blaðstilkars 	 blaðstilkar
breiskleika 	 breyskleika
ættkvís 	 ættkvísl
Testamentinu 	 testamentinu
Halldórssónar 	 Halldórssonar
menntskóli 	 menntaskóli
hefðbundna 	 Hefðbundna
háskólabókasafni 	 háskólabókasafns
Fólkvangurinn 	 Fólkvangur
rafhlaða 	 Rafhlaða
markíll 	 makríll
Eyrasundi 	 Eyrarsundi
kónungurinn 	 konungurinn
tíbetskum 	 tíbeskum
tíbetskum 	 tíbesku
tíbetsku 	 tíbeskum
tíbetsku 	 tíbesku
Suð-Vesturlandi 	 Suðvesturlandi
Kjarnefnafræði 	 kjarnefnafræði
annarar 	 annarrar
aðaltungumálið 	 aðaltungumál
Akkameníða 	 Akkamenída
öxulveldin 	 Öxulveldin
lfræðiheiti 	 fræðiheiti
Háaleiti 	 Háaleitis-
nyrðsta 	 nyrðsti
Ijsselmeer 	 IJsselmeer
alment 	 almennt
Fíladelfíuog 	 Fíladelfíu
flokkunum 	 flokkinum
kaffidrykkkur 	 kaffidrykkur
Avogardo 	 Avogadro
Turkmeristan 	 Turkmenistan
sjaldann 	 sjaldan
samgöngu 	 samgöngu-
sveitastjórnarráðuneytið 	 sveitarstjórnarráðuneytið
þíþróttavelli 	 íþróttavelli
Verkfæri 	 verkfæri
verkfæri 	 Verkfæri
Hreyfingin 	 hreyfingin
Norður-Pollandí 	 Norður-Póllandi
Bólavía 	 Bólivía
þrívíddarhönnunarfyrirtækinu 	 þrívíddarhönnunarfyrirtækið
ljóðbækur 	 ljóðabækur
Altbergs 	 Altberg
Reynistaðabræður 	 Reynistaðarbræður
Blettakarfans 	 blettakarfans
kvændur 	 kvæntur
Búningurinn 	 Búðingurinn
Yfirrannsóknarlögreglumaður 	 yfirrannsóknarlögreglumaður
Félagfræði 	 Félagsfræði
Félagfræði 	 Félagsfræði
Afrískum-Amerískum 	 afrískum-Amerískum
Púertórískum 	 púertórískum
hreyfigar 	 hreyfingar
fyrirtæki 	 te-fyrirtæki
Cassandra 	 Kassandra
Fjórgildur 	 fjórgildur
Mary 	 May
Langeland 	 Langaland
Sorbonne 	 -Sorbonne
-Sorbonne 	 Sorbonne
Díselolíu 	 díselolíu
vistkefði 	 vistkerfi
Stóra-Belti 	 Stórabelti
Litla-Belti 	 Litlabelti
Þéttmerskir 	 Þéttmerskis
skindilega 	 skyndilega
Þúkýdídes� 	 Þúkýdídes
decibel 	 desibel
upprunið 	 upprunnið
skelskrifta 	 skeljaskrifta
boginar 	 bognar
kvennkyns 	 kvenkyns
Tækniháskóli 	 Tækniskóli
Tækniskóli 	 Tækniháskóli
aðskilar 	 aðskildar
megilandi 	 meginlandi
ferskvatnsstöðuvötn 	 ferskvatnsstöðuvötnum
Konfúsíanisma 	 konfúsíanisma
Daóisma 	 daóisma
Asuturárdal 	 Austurárdal
Miðfjarðadala 	 Miðfjarðardala
Blettakarfar 	 blettakarfar
breiðskífa 	 Breiðskífa
Bandarísk 	 bandarísk
óárreittar 	 óáreittar
georgíska 	 Georgíska
verslunar- 	 verslunar–
Stuart 	 Stuarts
nýjir 	 nýir
Miklagljúfursþjóðgarður 	 Miklagljúfursþjóðgarðurinn
Nýji 	 Nýi
markaðsettir 	 markaðssettir
tridactylaer 	 tridactyla
mávategund 	 máfategund
hemspekingurinn 	 heimspekingurinn
samskiptamál 	 XML-samskiptamál
Alþjóðleg 	 alþjóðleg
alþjóðleg 	 Alþjóðleg
Aðgerðir 	 Aðgerð
plöntuleyfar 	 plöntuleifar
Revelation 	 Revelations
Hveititegund 	 hveititegund
staðseettur 	 staðsettur
Rómverskri 	 rómverskri
bóndabæjana 	 bóndabæjanna
Capa· 	 Capa
nátengra 	 nátengdra
Algonkískra 	 algonkískra
Kaliforníuháskóli 	 Kaliforníuháskóla
Íslenskuna 	 íslenskuna
Fylking 	 fylking
Fylking 	 fylking
Wiek 	 Wieck
Wiek 	 Wieck
Wiek 	 Wieck
Wiek 	 Wieck
Anakondan 	 anakondan
Kirkjubø 	 Kirkjubæ
lyktarskin 	 lyktarskyn
sták 	 strák
Jökulstaðir 	 Jökulsstaðir
Landnámsöld 	 landnámsöld
ríbósómí 	 ríbósóm
Listernia 	 Listeria
Nestoríusi 	 Nestoríosi
Alpafjallaeða 	 Alpafjalla
Rúllstigar 	 Rúllustigar
fornleifarannsóknir 	 Fornleifarannsóknir
Promakkos 	 Promakkosar
Mary 	 May
Mary 	 May
May 	 Mary
May 	 Mary
hérþjálfun 	 herþjálfun
neytandum 	 neytendum
Asiaat 	 Aasiaat
amharíska 	 Amharíska
kvikmyndagerðafyrirtæki 	 kvikmyndafyrirtæki
aðalega 	 aðallega
lýsngu 	 lýsingu
Sjálfstæðaflokksins 	 Sjálfstæðisflokksins
djasssöng 	 jasssöng
Laó-tse 	 Laótse
Laótse 	 Laó-tse
bakeríi 	 bakaríi
Evrópumeistaratilinn 	 Evrópumeistaratitilinn
Móætisveppur 	 ætisveppur
Reifasveppsætt 	 reifasveppsætt
Stangveiðifélag 	 Stangaveiðifélag
Han 	 Hans
Stórborgarsvæði 	 Stórborgarsvæðið
Manchesters 	 Manchester
Manchesters 	 Manchester
Manchesterer 	 Manchester
Manchesterer 	 Manchester
Einsteins 	 Einstein
endan 	 endann
byrtist 	 birtist
Aust-Noregur 	 Austur-Noregur
Hagnýt 	 Hagnýtt
tónistarþættir 	 tónlistarþættir
Atlandshaf 	 Atlantshaf
munnmæli 	 Munnmæli
sameinadist 	 sameinaðist
skylningshæfni 	 skilningshæfni
Óánægður 	 óánægður
Madredues 	 Madredeus
Jane´s 	 Janes
Frostaþing 	 Frostuþing
Frostaþing 	 Frostuþing
Frostuþing 	 Frostaþing
Frostaþing 	 Frostuþing
Frostaþing 	 Frostuþing
Frostuþing 	 Frostaþing
Santoríni 	 Santorini
Guðfræði 	 guðfræði
víxlháðir 	 víxlháð
stækkadi 	 stækkaði
hrossahárum 	 hrossahári
Leibnitz 	 Leibniz
Kapítal 	 Kapítól
Lapplandsins 	 Lapplands
Krossferðirnar 	 Krossferðir
kattadýra 	 kattardýra
mótmælandatrú 	 mótmælendatrúar
metýlínbláu 	 metýlenbláu
miRNA 	 mRNA
RNA 	 mRNA
mRNA 	 miRNA
Boettgerilla 	 Boettgerillidae
Boettgerillidae 	 Boettgerilla
Orustan 	 Orrustan
félagslindir 	 félagslyndir
sjerkesar 	 Sjerkesar
ríkístjórninni 	 ríkistjórninní
vesturhluta 	 suðvesturhluta
Mannsæmandi 	 mannsæmandi
Skandinavíska 	 skandinavíska
Tetroninn 	 Tertoninn
Weierstrassfallið 	 Weierstrassfall
Weierstrass 	 Weierstraß
sérstakleg 	 sérstaklega
flugmannin 	 flugmanninn
Neðra-Saxlandi 	 Neðra-Saxlands
Hanover 	 Hannover
Neðra-Saxlandi 	 Neðra-Saxlands
Hanover 	 Hannover
grantum 	 granatum
miðjustjórninni 	 miðstjórninni
Hávamáli 	 Hávamála
áeldri 	 eldri
Meþýlkvikasilfur 	 Metýlkvikasilfur
Vedsyssel-Thy 	 Vendsyssel-Thy
innybyggðum 	 innbyggðu
veturninn 	 veturinn
úrferðarfall 	 íferðarfall
íferðafall 	 íferðarfall
frumbiggjamála 	 frumbyggjamála
littlu 	 litlu
Innfædd 	 innfædd
Astúríska 	 Astúría
astúríska 	 Astúríska
Spánni 	 Spáni
Astúría 	 Astúríska
Stjórnurarbókhald 	 Stjórnunarbókhald
ástralíu 	 Ástralíu
rétttrúnaðarkirkjan 	 Rétttrúnaðarkirkjan
Ástralskri 	 ástralskri
Epping-skógur 	 Eppingskógur
suðaustum 	 suðaustur
vinnslu 	 -vinnslu
geng-um 	 gengum
Ísraelska 	 ísraelska
Franska 	 Franskt
Franska 	 franska
geng-um 	 gengum
Ísraelska 	 ísraelska
Franska 	 Franskt
Franska 	 franska
lifrinar 	 lifrinnar
Grafískur 	 Grafískir
þrælahaldm 	 þrælahald
fornritafélag 	 Fornritafélagið
Fornritafélagið 	 fornritafélag
súcrósa 	 súkrósa
júpíters 	 Júpíters
dýraverndarástæðum 	 dýraverndunarástæðum
snorku 	 snorklu
eða 	 Leða
Leða 	 eða
Amtmannsetursins 	 Amtmannsetrinu
Stærfræði 	 Stærðfræði
Filtering 	 filtering
Myrtílusi 	 Myrtílosi
Norðurgermönsk 	 norðurgermönsk
Calasparra 	 calasparra
híeroglýfur 	 híeróglýfur
stjórnmáls- 	 stjórnmála-
hálfsmánaðarlegur 	 hálfsmánaðarlega
Siikileyjarþinur 	 Sikileyjarþinur
Nebrodi 	 Nebrodi-
indíánar 	 Indíánar
landshlutur 	 landshlutum
gítargrunn 	 gítargrunni
guðjónsson 	 Guðjónsson
silfur-gráan 	 silfurgráan
aðilan 	 aðilann
Hugtakið 	 hugtakið
hugtakið 	 Hugtakið
örgjörfum 	 örgjörvum
greinin 	 greinini
ob-úgríska 	 ob-úgrísk
greinini 	 greinin
sakmvæmt 	 samkvæmt
Amdang 	 Amdangtí
Amdangtí 	 Amdang
Tsjad 	 Tjad
Dnjepr 	 Dnjepur
Hollenska 	 Hollensku
Hollensku 	 Hollenska
Hvítrússnesk 	 hvítrússneska
hvítrússneska 	 Hvítrússnesk
sálfræðimeðferðum 	 sálfræðimeðferð
Montreal 	 Montréal
Kanadískt 	 kanadískt
Montreal 	 Montréal
Afbrigði 	 afbrigði
afbrigði 	 Afbrigði
Risaðeðlur 	 Risaeðlur
sameindarstigi 	 sameindastigi
Skálholtsbiskupsdæmi 	 Skálholtsbiskup
Skálholtsbiskup 	 Skálholtsbiskupsdæmi
Túnætisveppur 	 ætisveppur
útgávum 	 útgáfum
fornritafjelagsins 	 fornritafélagsins
Germönsk 	 Germönskum
steindaldarhörpinni 	 steindaldarhörpunni
Áburðasala 	 Áburðarsala
Adelska 	 adelska
adelska 	 Adelska
landmærinu 	 landmærunum
hamskifti 	 hamskipti
Skamandríos 	 Skamandrosi
Repúblikana 	 repúblikana
mastersgráði 	 mastersgráðu
Eyjarnar 	 eyjarnar
hreyfadýra 	 hreifadýra
fjölsnertiskjám 	 fjölsnertiskjáinn
Þjóðkirkjunar 	 Þjóðkirkjunnar
fjölsnertiskjám 	 fjölsnertiskjáinn
Þjóðkirkjunar 	 Þjóðkirkjunnar
hennt 	 hent
Kalkoþecu 	 Kalkoþeku
Híjómsveitin 	 Hljómsveitin
Menntamálaráðuneytið 	 menntamálaráðuneytið
Hip-hop-tónlist 	 Hipphopp-tónlist
Badaríkjamenn 	 Bandaríkjamenn
ákveðn 	 ákveðin
borgfirðinga 	 Borgfirðinga
Nasista 	 nasista
þekkingarfræðileg 	 þekkingarfræðilegri
múspell 	 Múspell
The 	 ‚The
Afanti阿凡提 	 Afanti‘阿凡提
Alþingismenn 	 alþingismenn
Kommúnan 	 kommúnan
Vietnam 	 Víetnam
fucked-up-strange-sögurþráð 	 fucked-up-strange-söguþræði
prófunarstofuna 	 prófunarstofnunin
faggildingu 	 faggyldingu
Afbrigði 	 afbrigði
afbrigði 	 Afbrigði
efmafæðilega 	 efnafæðilega
Karlamangúsi 	 Karlamagnúsi
vesturheimi 	 Vesturheimi
mikklum 	 miklum
mikklu 	 miklu
Kýpverskur 	 kýpverskur
Jóhannessen 	 Johannessen
Útkirtill 	 kirtill
kirtill 	 Útkirtill
Fucaceae 	 fucaceae
Þjóðveldisflokkurinn 	 Tjóðveldisflokkurin
Tjóðveldisflokkurin 	 Þjóðveldisflokkurinn
Amelíuborgin 	 Amalíuborgin
Amelíuborg 	 Amalíuborg
Brúttoverð 	 Brúttóverð
kostsnaði 	 kostnaði
endur-nefna 	 endurnefna
Oklohoma 	 Oklahoma
hljómplötum 	 SG-hljómplötum
Fundst 	 Fundist
Fornpersnesku 	 fornpersnesku
Fundst 	 Fundist
Fornpersnesku 	 fornpersnesku
Germönsk 	 Germönskum
austurgermönsk 	 vesturgermönsk
vesturgermönsk 	 austurgermönsk
Krókfjarðarness 	 Króksfjarðarness
Gregoríanska 	 Gregoríska
centripetal 	 Centripetal
conservation 	 Conservation
sagnfræðskólanum 	 sagnfræðiskólanum
drógst 	 dróst
Skordýr 	 skordýr
skordýr 	 Skordýr
Stærsta 	 stærsta
stærsta 	 Stærsta
Slönguvaður 	 slönguvaður
slöngvivaður 	 slönguvaður
Mjólkurhvítt 	 mjólkurhvítt
margbreytileg 	 myndmargbreytileg
Guanaco 	 guanaco
Vísundur 	 Vísundar
Áxöxtur 	 Ávöxtur
plötuskilja 	 plötuskil
körfuknattleiksmót 	 körfuknattleik
eftri 	 efri
Hoiflugvöllur 	 Hoi-flugvöllur
Víetnamu 	 Víetnam
einkaeign 	 einkaeigu
Frönskum 	 frönskum
Skoskum 	 skoskum
bjórtegund 	 bjórategund
Fjölbrautaskólinn 	 Fjölbrautaskólans
Halloumi 	 halloumi
geita- 	 geitar-
sauðmjólk 	 sauðamjólkur
halloumi 	 Halloumi
Betlehemhverfinu 	 Betlehemshverfinu
Tadsjikistan 	 Tadsikistan
Joliet-Curie 	 Joliot-Curie
snjónbaug 	 sjónbaug
Hluturinn 	 hluturinn
mgsinθ 	 m·g·sinθ
hluturinn 	 Hluturinn
Flaggskip 	 Flaggskipið
eittthvert 	 eitthvert
einliða- 	 einliða
umluknar 	 umluktar
Bjallan 	 bjallan
Vága 	 Vágar
Floghafn 	 Floghavn
Vágar 	 Vága
Þjóverja 	 Þjóðverja
Hellsing 	 Hellsings
Hellsings 	 Hellsing
Blettakarfans 	 blettakarfans
yffirráðasvæði 	 yfirráðasvæðin
hanns 	 hans
hanns 	 hann
aðalsöngvarinn 	 aðalsöngvari
aðalega 	 aðallega
Kasakstan 	 Kasakstana
Utandeild 	 utandeild
Hessíska 	 hessíska
hessíska 	 Hessíska
Hesse 	 Hessen
vítamína 	 C-vítamína
Ijsselmeer 	 IJsselmeer
Stenolepis 	 stenolepis
Labrador 	 labrador
Labrador 	 labrador
labrador 	 Labrador
labrador 	 Labrador
Itchi 	 Itachi
Samúræji 	 Samúræi
brjóstfiska 	 brjóskfiska
skötuættbálk 	 skötuættbálki
auglýsinga-iðnaðinum 	 auglýsingaiðnaðinum
tálknmunnar 	 Tálknmunnar
heittempruðum- 	 heittempruðum
adríahafinu 	 Adríahafinu
Útskrifaðist 	 útskrifaðist
basneska 	 baskneska
Blóðsótt 	 blóðsótt
saurinum 	 saurnum
Brandenburg 	 Brandenborg
Brandenborg 	 Brandenburg
Brandenborg 	 Brandenburg
Fræðiheiti 	 fræðiheiti
bipustalatus 	 bipustulatus
Langdom 	 Langdon
háksólanám 	 háskólanám
Lama 	 Lamar
háksólanám 	 háskólanám
Lama 	 Lamar
Sýslumenn 	 sýslumenn
sýslumenn 	 Sýslumenn
Glysþungarokkið 	 Glysþungarokk
laufblðð 	 laufblöð
Hraunsvötn 	 Hraunsvatn
skamstöfun 	 skammstöfun
acuparia 	 aucuparia
jafnvægiskenninguna 	 jafnvægiskenningu
Jómsvikingadrápa 	 Jómsvíkíngadrápa
Kaldananeskirkja 	 Kaldrananeskirkja
keltneksur 	 keltneskur
rómaríki 	 Rómaríki
menningamálaráðherra 	 menningarmálaráðherra
listamannalaua 	 listamannalauna
regression 	 Regression
exponential 	 Exponential
norður-Indlandi 	 Norður-Indlandi
Snjókrabbi 	 snjókrabbi
Snjókrabbi 	 snjókrabbi
Snjókrabbi 	 snjókrabbi
Snjókrabbi 	 snjókrabbi
svipupum 	 svipuðum
nyrðst 	 nyrst
natríumhýdroxíð 	 natrínhýdroxíð
natrínhýdroxíð 	 natríumhýdroxíð
jóniskt 	 jónískt
Miðstöðu 	 Miðstöð
útskrifaðist 	 Útskrifaðist
Harrierþotnanna 	 Harrier-þotanna
hvernig 	 Hvernig
skildunámi 	 skyldunámi
hvernig 	 Hvernig
skildunámi 	 skyldunámi
fjallrætur 	 fjallsrætur
Halógen 	 Halógenar
Smáíbúðahverfi 	 Smáíbúðahverfið
Húsapuntur 	 húsapuntur
knatspyrnu 	 knattspyrnu
knatspyrnu 	 knattspyrnu
Kraftframherja 	 kraftframherjar
Bitpop 	 Bitpopp
eingar 	 engar
þjóðarflokkurinn 	 Þjóðarflokkurinn
hreyfirfræðilega 	 hreyfifræðilega
Gunn¬laugsdóttir 	 Gunnlaugsdóttir
alþjóða¬mál 	 alþjóðamál
sér¬verkefnin 	 sérverkefnin
Háskólum 	 háskólum
Innranet 	 innranet
dreyfir 	 dreifir
Norð-Austurlandi 	 Norðausturlandi
Gondwana-útbreiðsla 	 Gondvana-útbreiðsla
Australasía 	 Australasíu
samóyedíska 	 samójedíska
armenska 	 Armenska
Nagórnó-Karabak 	 Nagornó-Karabak
tónlíst 	 tónlist
tónlíst 	 tónlist
jafnvél 	 jafnvel
gítarum 	 gítörum
neiddur 	 neyddur
fænda 	 frænda
Evrópulöndum 	 evrópulöndum
leiðbieiningum 	 leiðbeiningum
Helsingjaborg 	 Helsingborg
Helsingjaborg 	 Helsingborgs
Helsingborg 	 Helsingjaborg
Helsingborg 	 Helsingborgs
Helsingborgs 	 Helsingjaborg
Helsingborgs 	 Helsingborg
jökulhlaup 	 Jökulhlaup
Sigfússon 	 Sigfússons
Sigfússons 	 Sigfússon
Staðreyndir 	 staðreyndir
Mismunandi 	 mismunandi
mismunandi 	 Mismunandi
ogFrakkland 	 Frakkland
Heitið 	 Heiti
Norrænni 	 norrænni
brúðkauðinu 	 brúðkaupinu
þrælahald 	 Þrælahald
andalúsíska 	 Andalúsíska
Axlargrindin 	 axlargrindina
axlargrindina 	 Axlargrindin
hydroxíð 	 hýdroxíð
baskneska 	 Baskneska
Brennivín 	 brennivín
upphaflega 	 Upphaflega
þurrkt 	 þurrt
Patrcik 	 Patrick
Suskind 	 Süskind
Ilminn 	 Ilmurinn
KK-sexttettinn 	 KK-sextettinn
verklög 	 verklag
aðskilnum 	 aðskildum
Map 	 Maps
Háskóla 	 Háskólann
Háskólans 	 Háskóla
Háskólans 	 Háskólann
sjóin 	 sjóinn
koddaskelin 	 koddaskelina
koddaskelina 	 koddaskelin
Bandaríkjana 	 Bandaríkjanna
foreldrar 	 Foreldrar
eðileg 	 eðlileg
DNS-lén 	 DNS-léni
att-merki 	 at-merki
Landadalsfjalls 	 Langadalsfjalls
Ofur-Huga 	 Ofurs-Huga
sini 	 sinni
Bandarísk 	 bandarísk
efti 	 eftir
Þvermál 	 þvermál
askúnska 	 Askúnska
indóírönskt 	 indóíranskt
tungnumál 	 tungumál
Asovhaf 	 Asovshaf
Póseidon-Erekþeius 	 Póseidon-Erekþeifi
Galíleótunglum 	 Galíleótunglunum
Teiknimyndaþættir 	 teiknimyndaþættir
Vestur-Atlandshafi 	 Vestur-Atlantshafi
varaborgarfulltrúi 	 borgarfulltrúi
Háskólann 	 Háskólinn
Inuítamál 	 Inúítamál
eskimó-aleutísk 	 eskimó-aleútísk
Cornell-háskólanum 	 Cornell-háskóla
hofuðið 	 höfuðið
Vestmanneyjar 	 Vestmannaeyjar
dreyfst 	 dreifst
meinvörpun 	 meinvörpum
Markárfljótsósum 	 Markarfljótsósum
Þjóðvegi 	 Þjóðveg
skíðihvala 	 skíðishvala
pop-rokk 	 popp-rokk
Járnsmiðsætt 	 járnsmiðsætt
grá-blátt 	 gráblátt
svart-blátt 	 svarblátt
Stundaði 	 stundaði
fjölkskyldna 	 fjölskyldna
Fyrirsögn 	 fyrirsögn
fyrirsögn 	 Fyrirsögn
landshlutinum 	 landshlutanum
snjókrabbi 	 snjókrabba
framsóknaflokksins 	 Framsóknarflokksins
Ótriggssonar 	 Ótryggssonar
ins 	 hins
Gjeirmundi 	 Geirmundi
Bjarhéðinsson 	 Bjarnhéðinsson
larici-pentandrae 	 laricis-pentandrae
kynþrosta 	 kynþroska
skratskrift 	 skrautskrift
P-keltnesk 	 Q-keltnesk
keltíberísk 	 kelt-íberísk
Q-keltnesk 	 P-keltnesk
Limburg 	 Limbourgh
Limbourgh 	 Limburg
reiðurbúin 	 reiðubúin
gyftast 	 giftast
Uppgvötun 	 Uppgötvun
Fræðiheiti 	 fræðiheiti
upplýsingafyritæki 	 upplýsingafyrirtæki
starsfemi 	 starfsemi
iglu 	 igdlu
igdlu 	 iglu
fjallin 	 fjallið
Íbúðarlánasjóður 	 Íbúðalánasjóður
Veruleiki 	 veruleiki
Eydalín 	 Eydalíns
ólíulampa 	 olíulampa
náttúrinni 	 náttúrunni
stjórmálaflokkur 	 stjórnmálaflokkur
Vitoria-Gastiez 	 Vitoria-Gasteiz
fjórvegur 	 Fjórvegur
Alþingiskosninga 	 Alþingiskosninganna
Fribourg 	 Freiburg
Fribourg 	 Friburgo
Fribourg 	 Friburg
Freiburg 	 Fribourg
Freiburg 	 Friburgo
Freiburg 	 Friburg
fjórvegur 	 Fjórvegur
Alþingiskosninga 	 Alþingiskosninganna
Fribourg 	 Freiburg
Fribourg 	 Friburgo
Fribourg 	 Friburg
Freiburg 	 Fribourg
Freiburg 	 Friburgo
Freiburg 	 Friburg
hugbúnaðarverkfræðingar 	 hugbúnaðarverkfræði
raðgreiningaraðferð 	 DNA-raðgreiningaraðferð
raðgreiningaraðferð 	 raðgreiningaraðferða
raðgreiningaraðferða 	 DNA-raðgreiningaraðferð
títan-díoxíð 	 títandíoxíð
littlum 	 litlum
kortavarpanir 	 kortavarpana
kortavarpana 	 kortavarpanir
Hamlets 	 Hamlet
höfuðbol 	 höfuðból
Kínversku 	 kínversku
Argentina 	 Argentína
´´Grosse 	 Grosse
Pointe´´ 	 Pointe
tækniháskólinnn 	 Tækniháskólinn
fjölgevingsform 	 fjölgervingsform
Ameríska 	 ameríska
Hverfahlutinn 	 Hverfishlutinn
Hverfahlutinn 	 Hverfishlutinn
kattarmatur 	 kattamatur
græntmeti 	 grænmeti
dingoar 	 dingóar
héraðið 	 Héraðið
frjósamann 	 frjósaman
kalkríkann 	 kalkríkan
Sjónvarpinu 	 sjónvarpinu
keðjurekjandi 	 keðjureykjandi
Moores 	 Moore
Kaupmannahafnar-svæðinu 	 Kaupmannahafnarsvæðinu
keltíberísk 	 kelt-íberísk
Kants 	 Kant
Edduverðlaunin 	 Edduverðlaunanna
edduverðlaunanna 	 Edduverðlaunanna
Barrtrjáa 	 barrtrjáa
Furuætt 	 furuætt
Einisætt 	 einisætt
úran 	 úran-
úran 	 úran-
úran 	 úran-
úran 	 úran-
úran- 	 úran
úran- 	 úran
úran- 	 úran
úran- 	 úran
Valakíu 	 Vallakíu
tyrkjum 	 Tyrkjum
ströndu 	 strönd
ofaní 	 ofan
annarar 	 annarrar
angáríska 	 Angáríska
þýskalandi 	 Þýskalandi
digitadöbb 	 digidöbb
Aðgerðasinnaranarkistar 	 aðgerðasinnaanarkista
krónísk 	 krónísku
lifurvandamál 	 lifrarvandamáli
krónísk 	 krónísku
lifurvandamál 	 lifrarvandamáli
Anakondur 	 anakondur
Anakondur 	 anakondur
Anakondur 	 anakondur
Anakondur 	 anakondur
Intestinalis 	 intestinalis
Framsóknaflokkurinn 	 Framsóknarflokkurinn
Aþýðuflokkin 	 Alþýðuflokkurinn
Hawai 	 Hawaii
summt 	 sumt
Kulborðið 	 Kulborði
starfnar 	 starfar
lestarökutæki 	 lestarökutækja
vituvefur 	 fituvefur
Phou 	 Phu
Phu 	 Phou
Predikunarstóllin 	 Predikunarstóllinn
Norðurhlið 	 norðurhlið
tölvuleikja 	 tölvuleikja-
snjósleða 	 sjósleða
Snóksnes 	 Snóksneser
noraðir 	 notaðir
vinýlklóríðs 	 vínýlklóríðs
vinýlklóríðs 	 vínýlklóríðs
spurningamerki 	 spurningarmerki
greinamerki 	 greinarmerki
Lystigarðinum 	 Lystigarði
Fermi 	 Fermis
Okotshaf 	 Okotskhaf
Kyrrahafsstrandar 	 Kyrrahafsströnd
Espresso 	 Espressó
Rómarveldi 	 Rómaveldi
Rómarveldi 	 Rómaveldi
Balkansaga 	 Balkanskaga
páskahella 	 Páskahella
Hjólreiðahjálmurinn 	 Hjólreiðahjálmar
Victory 	 Viktory
bítlarnir 	 Bítlarnir
styja 	 styðja
stríðana 	 stríðanna
Karþagóbúi 	 Karþagóbúar
poenici 	 Poenici
Blackmore 	 Blackmores
Spira’ 	 Spira
ráðherran 	 ráðherrann
Kamøy 	 Karmøy
Fnjóskárdal 	 Fnjóskadal
Bárðadal 	 Bárðardal
Æskulýðssambandi 	 Æskulýðssambands
Prestafélagi 	 Prestafélags
fleygð 	 fleyguð
fleygð 	 fleyguð
munaðarleysingjanns 	 munaðarleysingjans
Mið-Asía 	 Mið-Asíu
Letidýr 	 letidýr
Gemini 	 Gemini-
eyjunna 	 eyjuna
Allium 	 llium
Balkanskaga 	 Balkanskagaog
Hljómsveitinni 	 hljómsveitinni
Höfuðborgin 	 Höfuðborg
boðskipta 	 boðskipta-
rafmagn 	 rafmagns-
Bankastjórnar 	 bankastjórnar
Svíþjóðardemókratarnir 	 Svíþjóðardemókratar
hljómssveit 	 hljómsveit
ordóvisíum 	 Ordóvisíum
Copenhaguen 	 Copenhagen
Kaupmannhöfn 	 Kaupmannahöfn
flutningarþyrlna 	 flutningarþyrlur
Fenrisúlfur 	 Fenrisúlfi
Fenrisúlfur 	 Fenrisúlfi
sveitafélag 	 sveitarfélag
Árið 	 Ári
Landsvæði 	 Landsvæðið
Suðureijum 	 Suðureyjum
Lake 	 Lakes
Lakes 	 Lake
nátturunni 	 náttúrunni
nátturulegt 	 náttúrlegt
náttúrinni 	 náttúrunni
Guðsmóðir 	 guðsmóðir
fjárhættspil 	 fjárhættuspil
Mýrdalshreppur 	 Mýrdalshreppi
loftfyrrtar 	 loftfirrtar
loftfyrrtu 	 loftfirrtu
Íranski 	 íranski
sýdar 	 sýndar
borðnir 	 bornir
indó-íranskra 	 indóíranskra
indó-arísk 	 indóarísk
ítalsk 	 ítalskt
Austral-háskoli 	 Austral-háskóli
Bakteríuveira 	 Bakteríuveirur
íslendinga 	 Íslendinga
íslendingafélag 	 Íslendingafélag
Háfiskar 	 Háffiskar
Henn 	 Henni
Úralskt 	 úralskt
Rafaele 	 Rafaels
evrópu 	 evrópsku
A-Barðastrandasýslu 	 Austur-Barðastrandasýslu
Montreal 	 Montréal
Skógarþöll 	 skógarþöll
Fagurþöll 	 fagurþöll
Frederiksstad-hverfinu 	 Frederiksstaden-hverfinu
N-Ameríka 	 N-Ameríku
N-Ameríka 	 N-Ameríku
N-Ameríku 	 Ameríku
svóru 	 sóru
spillefni 	 spilliefni
spillefni 	 spilliefni
Springer 	 Springers
Springers 	 Springer
vaðmálsbúta 	 vaðmálsbútar
Capelhinhos 	 Capelinhos
kʁistin 	 Kʁistin
barrskógaog 	 barrskóga
Hráefni 	 hráefni
Rupicapra 	 rupicapra
rupicapra 	 Rupicapra
Miðameríku 	 Mið-Ameríku
Suðurameríku 	 Suður-Ameríku
Hljóðdvalabreyting 	 Hljóðdvalarbreytingin
breiting 	 breyting
andúð 	 íandúð
íslendinga 	 Íslendinga
jurta-te 	 jurtate
Saudi-Arabíu 	 Sádi-Arabíu
íslendinga 	 Íslendinga
íslendingafélag 	 Íslendingafélag
Mandarín 	 mandarín
mandarín 	 Mandarín
miðbaut 	 miðbaug
Tsjadvatns 	 Tjadvatns
hanns 	 hans
hanns 	 hans
hanns 	 hans
hanns 	 hans
hægri 	 hægri-
Spartium 	 spartium
Occultation 	 occultation
Kalígúla 	 Calígúla
Calígúla 	 Kalígúla
Þjóðaratkvæðagreiðslan 	 þjóðaratkvæðagreiðsla
þjóðaratkvæðagreiðsla 	 Þjóðaratkvæðagreiðslan
Association 	 Associazione
Flokkurinn 	 flokkurinn
Stenbeck 	 Steinbeck
Διόνυσος 	 Διώνυσος
Διώνυσος 	 Διόνυσος
Börg 	 Björg
Færeyska 	 færeyska
Færeyska 	 færeyska
Færeyska 	 færeyska
Færeyska 	 færeyska
áratugsins 	 áratugarins
Steven 	 Stevens
myndst 	 myndast
randomization 	 Randomization
Málfræði 	 málfræði
málfræði 	 Málfræði
Nýársdagur 	 nýársdagur
Stundaði 	 stundaði
Rhodesstyrki 	 Rhodesstyrk
Afleiðing 	 afleiðing
óhefðbundin 	 óhefðbundnar
Svaraði 	 svaraði
Íhaldsmanna 	 íhaldsmanna
Svipunnar 	 svipunnar
Þjóstarson 	 Þjóstarsson
Álptanesi 	 Álftanesi
Ísraela 	 Ísraelska
Eredevisie 	 Eredivisie
Roger 	 Rogers
Halíðajónir 	 halíðjónir
skólastjóri 	 Skólastjóri
Hogwarts 	 Hogwart
Kanos 	 Kano
Kano 	 Kanos
járn-þríhyrningurinn 	 járnþríhyrningurinn
Kalífadæmi 	 kalífadæmið
Rasídaveldið 	 Rasídunveldið
kalífadæmið 	 Kalífadæmi
meginn 	 megin
Mikilvægasti 	 Mikilvægasta
heimsstyrjöldinni 	 heimstyrjöldinni
Pinakotheke 	 Pinakoþeke
Samgöngu- 	 samgöngu-
Samgöngu- 	 samgöngu-
plöntuleyfum 	 plöntuleifum
Newton 	 Newtons
teiknimyndaþættir 	 teiknimyndaþáttur
tvinnfallagreining 	 Tvinnfallagreining
Íþróttir 	 íþróttir
Badminton 	 badminton
Frjálsar 	 frjálsar
íþróttir 	 Íþróttir
Körfuknattleikur 	 körfuknattleikur
tímaritiðið 	 tímaritið
tímaritiðið 	 tímaritið
mostrarskegg 	 Mostrarskegg
rank 	 rak
Nafnið— 	 Nafnið
Affenrå— 	 Affenrå
sósjalíska 	 sósíalíska
græningjaflokkinum 	 græningjaflokknum
nefdarstörfum 	 nefndarstörfum
basknesku-íslensku 	 basknesk-íslenska
Bandaríska 	 bandaríska
Íslensku 	 íslensku
áhugagrasafræðings 	 áhugagrasafræðingi
fjölsylda 	 fjölskylda
sameinuðu 	 Sameinuðu
fjölsylda 	 fjölskylda
sameinuðu 	 Sameinuðu
kent 	 kennt
»hjör 	 hjör
Heimdalls« 	 Heimdalls
straunlínulagaðra 	 straumlínulagaðra
Inn 	 Inni
facebook 	 Facebook
soundcloud 	 Soundcloud
bandcamp 	 Bandcamp
Kóralvif 	 Kóralrif
Fornöld 	 fornöld
Miðaldir 	 miðaldir
Nútímann 	 nútímann
allþjóða 	 alþjóða
Simpson-fjölskylduna 	 Simpsonfjölskylduna
fyrrveransi 	 fyrrverandi
Suður-Þingeyjasýsla 	 Suður-Þingeyjarsýsla
Stundaði 	 stundaði
Alatáfjöll 	 Alatáfjöllum
Norgs 	 Noregs
Knykirtlar 	 Kynkirtlar
Zíonismi 	 síonismi
stjónrmálum 	 stjórnmálum
verlaun 	 verðlaun
ákveðin 	 Ákveðin
Tungufljot 	 Tungufljót
fimmoddótri 	 fimmoddóttri
fimmoddótri 	 fimmoddóttri
breitir 	 breytir
Hamilton‘s 	 Hamilton
almmennt 	 almennt
undirstöðu 	 undirstöðunám
hydragyros 	 hydrargyros
kvískerjabræður 	 Kvískerjabræður
netþráðlausu 	 þráðlausu
Breskra 	 breskra
Breskra 	 Breska
Purdue-háskóli 	 Purdue-háskóla
Purdue-háskóla 	 Purdue-háskóli
heimavist 	 heimavistnni
lýðvelsis 	 lýðveldisins
Samtengingar 	 samtengingar
Samtengingar 	 samtengingar
samtengingar 	 Samtengingar
samtengingar 	 Samtengingar
heimalingar 	 heimalningar
heimalingar 	 heimaalningar
Whos 	 Who
Who 	 Whos
systkinjapör 	 systkinapör
More 	 Moore
náttúruvísindaleg 	 náttúruvísindalega
Kalvínistar 	 kalvínistar
ráðherran 	 ráðherrann
Dusseldorf 	 Düsseldorf
Pútíns 	 Pútín
Nemstovs 	 Nemtsovs
Pútín 	 Pútíns
Marshalláætlunin 	 Marshalláætluninni
stríðsskaðabætna 	 stríðsskaðabóta
þjóðverjum 	 Þjóðverjum
ýmisum 	 ýmsum
íslendingar 	 Íslendingar
færeyingar 	 Færeyingar
íslendingar 	 Íslendingar
færeyingar 	 Færeyingar
djöfullin 	 djöfullinn
Heittempraða 	 Heittemprað
loftslagsbelti 	 loftslagsbeltum
gróðsetja 	 gróðursetja
rafstöðu-aðlöðun 	 rafstöðu-aðlöðunar
útbreiðslusvæniu 	 útbreiðslusvæðinu
veitingarhús 	 veitingahús
Rannsóknir 	 rannsóknir
Hamel 	 Hameln
Hameln 	 Hamel
Rússneska 	 rússneska
fönixmeðlimi 	 Fönixmeðlimi
Moody’s 	 Moodys
Standard’s 	 Standards
Poor’s 	 Poors
Umsátur 	 umsátur
umsátur 	 Umsátur
Alladín 	 Aladdín
Sönnunargögninn 	 Sönnunargögnin
Bangladesh 	 Bangladess
euhemerismi 	 evhemerismi
lávaxinn 	 lágvaxinn
lávaxinn 	 lágvaxinn
svoköllumðum 	 svokölluðum
mengjafræðinar 	 mengjafræðinnar
hungursneyðarinna 	 hungursneyðarinnar
bengalbúum 	 Bengalbúum
Plöntusvif 	 plöntusvif
millímetra 	 millimetra
Jónhannes 	 Jóhannes
Combinatorics 	 Combinatoricsog
conditional 	 Conditional
squish-squash 	 Squish-squash
Íslensku 	 íslensku
Spænsku 	 spænsku
Portúgölsku 	 portúgölsku
Finnsku 	 finnsku
karótínlitarefna 	 karótínlitarefnum
kúarbjöllur 	 kúabjöllur
kongótrommur 	 kóngótrommur
Þjóðsöngur 	 þjóðsöngur
Madagasgar 	 Madagaskar
Madagasgar 	 Madagaskar
Madagasgar 	 Madagaskar
Madagasgar 	 Madagaskar
Strandfuru 	 strandfuru
Einhyrninginn 	 einhyrninginn
undanskyldu 	 undanskildu
Acropole 	 Akropole
Araucanía-fylku 	 Araucanía-fylkis
Ríos-fylku 	 Ríos-fylkis
Ferðaskrifstofa 	 ferðaskrifstofu
Ferðaskrifstofa 	 ferðaskrifstofa
Miðpersnesku 	 miðpersnesku
Miðpersnesku 	 persnesku
Pahlavi 	 pahlavi
Persnesku 	 persnesku
Þjóðanna 	 þjóðanna
Ferðaskrifstofa 	 ferðaskrifstofu
Ferðaskrifstofa 	 ferðaskrifstofa
Miðpersnesku 	 miðpersnesku
Miðpersnesku 	 persnesku
Pahlavi 	 pahlavi
Persnesku 	 persnesku
Þjóðanna 	 þjóðanna
Gauß-Jordan 	 Gauss-Jordan
Gauß-eyðingu 	 Gauss-eyðingu
uprunalegri 	 upprunalegri
Jötunheimi 	 Jötunheimum
Edduverðlaunin 	 Edduverðlaunanna
edduverðlaunanna 	 Edduverðlaunanna
Norður-Atlandshafi 	 Norður-Atlantshafi
Prússneska 	 prússneska
aðgerðarsinna 	 aðgerðasinna
ráðstefnu 	 ráðstefnurit
ráðstefnurit 	 ráðstefnu
varm 	 varma
Tívolí 	 Tívolíið
Íþróttir 	 íþróttir
Körfuknattleikur 	 körfuknattleikur
Frjálsar 	 frjálsar
íþróttir 	 Íþróttir
Knattspyrna 	 knattspyrna
Norðurlandaráðss 	 Norðurlandaráðs
Norðurlandaráðss 	 Norðurlandaráðs
sýndarraunveruleika 	 sýndarveruleika
Appenínafjöllin 	 Appennínafjöllin
Fornloftlagsfræði 	 Fornloftslagsfræði
loftlagsbreytingar 	 loftslagsbreytingar
sýndarraunveruleika 	 sýndarveruleika
Appenínafjöllin 	 Appennínafjöllin
Fornloftlagsfræði 	 Fornloftslagsfræði
loftlagsbreytingar 	 loftslagsbreytingar
Eystra-og 	 Eystra-
Handklæði 	 handklæði
handklæði 	 Handklæði
vesópressín 	 vasópressín
Speleology 	 speleology
Hellafræði 	 hellafræði
Lyngrósategundir 	 lyngrósategundir
Lásbogi 	 Lásabogi
Hoja 	 Hodja
Hoja 	 Hojja
Hodja 	 Hoja
populus 	 Populus
Auschwithz 	 Auschwitz
Nasista 	 nasista
Pýþógórasar 	 Pýþagórasar
stofuðu 	 stofnuðu
Panthera 	 panthera
Panthera 	 panthera
Íslenska 	 íslenska
fjölskyldunar 	 fjölskyldunnar
skiltist 	 skiptist
Norwegiæ 	 Norvegiæ
suðuraustri 	 suðaustri
Mecklenborg-Vorpommern 	 Mecklenburg-Vorpommern
Mecklenburg-Vorpommern 	 Mecklenborg-Vorpommern
fleirri 	 fleiri
Míanmar 	 Mjanmar
hanst 	 hans
Domitiusar 	 Domitius
Ahenobarbusar 	 Ahenobarbus
Han 	 Hans
upplýsinga 	 Upplýsinga
relation 	 Relation
attributes 	 Attributes
columns 	 Columns
frjóguð 	 frjóvguð
Íþróttafélag 	 íþróttafélag
íþróttafélag 	 Íþróttafélag
Einhyrningurinn 	 einhyrningurinn
Volksempfängervar 	 Volksempfängevar
aðallega 	 Aðallega
dýrsfrumur 	 dýrsfrumum
aðstæðu 	 aðstæðum
eðaCucurbita 	 Cucurbita
eðaCucurbita 	 Cucurbita
eðaCucurbita 	 Cucurbita
hlutaþrýstingur 	 hlutþrýstingur
gullregn 	 Gullregn
Alpinum 	 alpinum
Gljáandi 	 gljáandi
Hofshreppi 	 Hofsóshreppi
Hofsóshreppi 	 Hofshreppi
varmaþennslu 	 varmaþenslu
Kalinigrad 	 Kaliningrad
einkendis 	 einkenndist
Marg 	 Marge
Marge 	 Marg
Nu-metali 	 nu-metali
samsteypustjórn 	 Samsteypustjórn
forsetisráðherra 	 forsætisráðherra
staðsetningartalnakerfi 	 staðsetningatáknakerfi
gosögnin 	 goðsögnin
Austurkirkjunni 	 Vesturkirkjunni
Rósaættar 	 rósaættar
Náttskuggaættar 	 náttskuggaættar
Körfublómaættar 	 körfublómaættar
Pandalidaesem 	 Pandalidae
Starfsheitið 	 starfsheiti
starfsheiti 	 Starfsheitið
bannvænt 	 banvænt
‘platform’ 	 platform
Starfsheitið 	 starfsheiti
starfsheiti 	 Starfsheitið
bannvænt 	 banvænt
‘platform’ 	 platform
Geirangerfjord 	 Geirangerfjorden
Sand 	 and
and 	 Sand
and 	 Sand
Ijsselmeers 	 IJsselmeers
landsyfirréttar 	 Landsyfirréttar
tónlistartölublað 	 tónlistarblað
kóreískum-amerískum 	 afrískum-amerískum
kóreískum-amerískum 	 kóreskum-amerískum
stofnanahyggja 	 Stofnanahyggja
Business 	 business
amharísku 	 Amharísku
byrjunni 	 byrjun
konúngs 	 konungs
suður-London 	 Suður-London
forskeyti 	 Forskeyti
stj-rnunar 	 stjörnurnar
forskeyti 	 Forskeyti
stj-rnunar 	 stjörnurnar
Hallormsstaður 	 Hallormsstaða-
Hallormsstaður 	 Hallormsstaðar-
Hallormsstaða- 	 Hallormsstaður
Hallormsstaða- 	 Hallormsstaðar-
Hallormsstaðar- 	 Hallormsstaður
Hallormsstaðar- 	 Hallormsstaða-
frum-indóevrópska 	 Frumindóevrópska
Tolstoy 	 Tolstoj
Toreau 	 Thoreau
Listasafn 	 listasafn
listasafn 	 Listasafn
Adelaide 	 Adélaide
Tékkneski 	 tékkneski
aðgerðarsinninn 	 aðgerðasinninn
myntkörfulánin 	 myntkörfulán
Rebúblikana-demókrata 	 rebúblikana-demókrata
Sexukórall 	 Sexukórallar
Karabíahafinu 	 Karíbahafinu
Verðteygni 	 verðteygni
heimstyrjaldarinnar 	 heimsstyrjaldarinnar
Californiaeða 	 California
Ístungl 	 ístungl
ístungl 	 Ístungl
aravakíska 	 Aravakíska
aravakíska 	 aravakískt
Prímtöluskítandi 	 Frumtöluskítandi
Prímtöluskítandi 	 Frumtöluskítandi
glysþungarokksbanda 	 glysþungarokksbandanna
starfsækt 	 starfrækt
Ilpunktur 	 punktur
punktur 	 Ilpunktur
Morsárfoss 	 Morsárfossar
Morsárfossar 	 Morsárfoss
legst 	 leggst
Upprunalega 	 upprunalega
Snjór 	 ‚Snjór
hvítur 	 hvítur‘
hvítur 	 hvítur‘
Síberíu-flæðibasaltið 	 Síberíuflæðibasaltið
Hersins 	 hersins
Evrópskur 	 evrópskur
Ítalalska 	 Ítalska
Konsertarnir 	 Konsertar
Eyrarbyggju 	 Eyrbyggju
frumsk´ginum 	 frumskóginum
Demantar 	 Demantur
Demantar 	 demantar
fjölgervisform 	 fjölgervingsform
Dobermann 	 dobermann
pincher 	 pinscher
Dobermann 	 dobermann
Doberman 	 Dobermann
Doberman 	 doberman
-flokkur 	 -flokk
Labrator 	 Labrador
finnann 	 Finnann
Janson 	 Jansson
Anderson 	 Andersson
latneksu 	 latnesku
punctus 	 punctum
punctum 	 punctus
frumkvöðulsstarfsemi 	 frumkvöðlastarfsemi
burreimingu 	 þurreimingu
nægtahornið 	 Nægtahornið
gnægtarhornið 	 gnægtahornið
Foretisráðherra 	 Forsetisráðherra
Batmani 	 Batman
Mecklenburg-Vestur-Pommern 	 Mecklenborg-Vestur-Pommern
Smithsonian-stofnunin 	 Smithson-stofnunin
þjóðatungum 	 þjóðtungum
Kaupþing 	 Kaupþings
Suharti 	 Suharto
Noður-Asíu 	 Norður-Asíu
grunvöllur 	 grundvöllur
ákvæðisorð 	 Ákvæðisorð
síðfornaldar 	 fornaldar
frumdýrinum 	 frumdýrinu
bokkbjór 	 Bokkbjór
nefhjlóða 	 nefhljóða
fylgiorðu 	 fylgiorða
Bonaparte-ætt 	 Bónaparte-ætt
fylgiorðu 	 fylgiorða
Bonaparte-ætt 	 Bónaparte-ætt
ratchet 	 ratchet--
Grelöð 	 Grelöðu
Grelöðu 	 Grelöð
Chiles 	 Chile
Perús 	 Perú
Pódalsins 	 Pó-dalsins
Side-scan 	 side-scan
austur 	 austur-
dalssins 	 dalsins
myrkru 	 myrku
Sið-harðkjarni 	 Síð-harðkjarni
pönktonlistar 	 pönktónlistar
amphibiaer 	 amphibia
hernumnum 	 hernumdum
hernumnum 	 hernumdum
Sjónarvottaáhrifin 	 sjónarvottaáhrifin
áhorfendahrif 	 Áhorfendahrif
Amoebiasis 	 Amebiasis
Amebiasis 	 Amoebiasis
Tien-tai 	 tien-tai
Madhyamika 	 madhyamika
Jógakara 	 jógakara
innann 	 innan
stærðfræðinar 	 stærðfræðinnar
AumDevanagari 	 Devanagari
Basilika 	 Basilíka
erfðamengja 	 erfðamengjum
erfðamengja 	 erfðamengjum
erfðamengjum 	 erfðamengja
erfðamengjum 	 erfðamengja
vernjulegar 	 venjulegar
Heires 	 Heiress
lundaseyði 	 lundaseiði
Þorskaætt 	 þorskaætt
borgini 	 borginni
félaglynd 	 félagslynd
annari 	 annarri
Schengensamningnum 	 Schengen-samningnum
matvöruverslunarkeðja 	 matvöruverslanakeðja
Displacement 	 displacement
uppspuninn 	 uppspunin
Rowling‘s 	 Rowling
meginn 	 megin
meginn 	 megin
hægvaxa 	 hægvaxta
matmikklum 	 matmiklum
Hertogenbosch 	 ‘s-Hertogenbosch
‘s-Hertogenbosch 	 Hertogenbosch
Dormiens 	 dormiens
Toronto 	 Torontó
Toronto 	 UToronto
Toronto 	 Torontó
Toronto 	 Torontó
Toronto 	 UToronto
Toronto 	 Torontó
siðasti 	 síðasti
háreyst 	 háreist
Óðinns 	 Óðins
Hrefnusgötu 	 Hrefnugötu
tesseractshypercubes 	 Tesseract´shypercube´s
níuda 	 níunda
sauðfjárræktarreppur 	 sauðfjárræktarhreppur
þekt 	 þekkt
Hundinum 	 hundinum
Síð-pönk 	 Síðpönk
Post-punk 	 post-punk
tónlistarstefna 	 rokktónlistarstefna
Sófista 	 sófista
Verkfæri 	 Verkfærin
Stundum 	 stundum
stundum 	 Stundum
veðurathugnartímum 	 veðurathugunartímum
herleiðangrum 	 herleiðöngrum
feskvatn 	 ferskvatn
Ítalska 	 ítalska
Lawerence-flóa 	 Lawrence-flóa
Mexíkó-flóa 	 Mexíkóflóa
grannfræðilegum 	 grannfræðilegar
grannfræðilegar 	 grannfræðilegum
rétthrynda 	 rétthyrnda
þríhyrnina 	 þríhyrninga
þríhyrnina 	 þríhyrninga
Jasperþjóðgarðurinn 	 Jasper-þjóðgarðurinn
Sasukeog 	 Sasuke
Catalinu 	 Catilinu
Sandoyargöngin 	 Sandeyjargöngin
Júgoslavía 	 Júgóslavía
valdakynslóð 	 valdakynslóðar
Ísafjarðarjúp 	 Ísafjarðardjúp
samstendur 	 samanstendur
Megadeath 	 Megadeth
´´Friday 	 Friday
Lights´´ 	 Lights
norður- 	 Norður-
rómversk-kaþólksi 	 rómversk-kaþólski
rómversk-kaþólksi 	 rómversk-kaþólsku
Vulcanþotan 	 Vulcan-þotan
Flateyjarskagi 	 Flateyjardalsskagi
Flateyjardalsskagi 	 Flateyjarskagi
Historica 	 historica
Flateyjarskagi 	 Flateyjardalsskagi
Flateyjardalsskagi 	 Flateyjarskagi
Historica 	 historica
gjóskugígar 	 gjóskugíga
Anakondan 	 anakondan
Hogwarts 	 Hogwart
skólin 	 skóli
skólin 	 skólinn
viðáttumiklir 	 víðáttumiklir
undirbúningu 	 undirbúningur
Tignarheitin 	 tignarheitin
tignarheitin 	 Tignarheitin
Mælskufræðinni 	 Mælskufræðin
Hreinsun 	 hreinsun
ættgöfga 	 ættgöfgi
Historica 	 historica
Borealium 	 borealium
háþróðaður 	 háþróaður
Afbrigðin 	 afbrigðin
kalladir 	 kallaðir
einföldunnar 	 einföldunar
VASK 	 VSK
laggður 	 lagður
Geimsteinarnir 	 Gimsteinarnir
Hattarvík 	 Hattarvíkur
Mykines 	 Mykiness
sporvagnakerfi 	 sporvagankerfið
sporvagankerfið 	 sporvagnakerfi
Bolabítur 	 bolabítur
Bolabítur 	 bolabítur
gen 	 gene
notandaviðmót 	 notendaviðmót
Shuffle 	 shuffle
klofningarvopn 	 klofnunarvopn
Norrköping 	 Norrköpings
Norrköping 	 Norrköpings
eijarnir 	 eyjarnir
Reifasveppir 	 reifasveppir
staðartími 	 Staðartími
Flestir 	 flestir
Punjabi 	 Punjab
flestir 	 Flestir
grátviðar 	 grátviðarætt
tvísöngur 	 Tvísöngur
dökkrrauðir 	 dökkrauðr
Umhverfisvæn 	 Umhverfisvænustu
efnastjórnunaraðferðir 	 efnastjórnunaraðferðirnar
garðyrkju-olía 	 garðyrkjuolía
Þórarínn 	 Þórarinn
aldinbori 	 Aldinbori
aldinbori 	 aldinborri
Melolontha 	 melolontha
melolontha 	 Melolontha
Höfuðstaður 	 höfuðstaður
nærststærsta 	 næststærsta
höfuðstaður 	 Höfuðstaður
landmæri 	 landamæri
Þýsklandi 	 Þýskalandi
útsenditíðni 	 útsenditíðnum
útsenditíðnum 	 útsenditíðni
pottaplöntur 	 Pottaplöntur
pottaplöntur 	 Pottaplöntur
háskólinn 	 Háskólinn
smáskífuni 	 smáskífunni
héraðsdómstólarnir 	 Héraðsdómstólarnir
agangeislun 	 agnageislun
Ketlill 	 Ketill
ilbreiður 	 illbreiður
verndarsvæðunu 	 verndarsvæðunum
Knattspyrnufélag 	 knattspyrnufélag
Ryþmablús 	 ryþmablús
Kántrítónlist 	 kántrítónlist
vestur-Afríku 	 Vestur-Afríku
Efnahagskerfi 	 Efnahagskerfið
kaupmáttarjöfnuði 	 kaupmáttarjöfnuð
Frymisflétta 	 frymisflétta
vinnslu 	 vinnslu-
pökkunar 	 pökkunar-
Cousteaus 	 Cousteau
persónuleg 	 Persónuleg
hlómsveitir 	 hljómsveitir
vefkóngulær 	 vefköngulær
förukóngulær 	 föruköngulær
Thaibox 	 thaibox
Phenakistiscope 	 phenakistoscope
phenakistoscope 	 Phenakistiscope
sjónvarpssýning 	 sjónvarpssýningin
Bólívars 	 Bolívars
Bolibar 	 Bolíbar
Andrésfjöllunum 	 Andesfjöllunum
upphafstími 	 upphafstíma
Vallarsveifgras 	 Vallarsveifgrasi
vatnsgufa 	 Vatnsgufa
vita 	 vitha
vitha 	 vita
aukahlutverk 	 aukahlutverki
mirkraöflin 	 myrkraöflin
flöksuvatn 	 flöskuvatn
endurunnanlegt 	 endurvinnanlegt
flöksuvatn 	 flöskuvatn
endurunnanlegt 	 endurvinnanlegt
Asíufíllinn 	 asíufíllinn
Gresjufíllinn 	 gresjufíllinn
Skógarfíllinn 	 skógarfíllinn
eingyðistrú 	 Eingyðistrú
blóðrásakerfi 	 blóðrásarkerfi
Hnerrarót 	 hnerrarót
hnerrarót 	 Hnerrarót
Veratrum 	 veratrum
Federalistar 	 federalistar
landgögnuliðið 	 landgönguliðið
Heilagri 	 heilagri
Auðahringsdalur 	 Auðihringsdalur
Madrid 	 Madridar
kysnlóð 	 kynslóð
Fljölbreytnin 	 Fjölbreytnin
iðnværðingu 	 iðnvæðingu
skrýmsli 	 skrímsli
gagnsæðrar 	 gagnstæðrar
sameindarbyggingu 	 sameindabyggingu
comics 	 comic
comic 	 comics
Saíre 	 Saír
kynbótadóma 	 kynbótamat
kynbótamat 	 kynbótadóma
tungumálinn 	 tungumálin
Afíku 	 Afríku
Harleemolía 	 harlemolía
hegðunnar 	 hegðunar
hamlets 	 Hamlets
Hardcore 	 hardcore
»heimskastur 	 heimskastur
ása« 	 ása
Hryllingsbúðinni 	 hryllingsbúðinni
rússneska 	 Rússneska
Казань 	 Казан
Казан 	 Казань
Rússneska 	 rússneska
Ruditapes 	 ruditapes
Ruditapes 	 ruditapes
Caesars 	 Caesar
Caesar 	 Caesars
áhresla 	 áhersla
Ashikaga-sjóguna-þinginu 	 Ashikaga-sjógunaþinginu
hlýan 	 hlýjan
Samkynheigð 	 Samkynhneigð
Berberar 	 Berbar
þróaist 	 þróaðist
grunnaðgerðir 	 grunnaðgerðirnar
tvem 	 tveim
Iðnbyltingin 	 iðnbyltingin
Shía-múslimar 	 Sjía-múslimar
Villtu 	 Viltu
gengdarlausa 	 gegndarlausa
Þríhyrningstala 	 þríhyrningstalan
þríhyrningstalan 	 Þríhyrningstala
Kódíakeyju 	 Kódíak-eyju
Tröllahvönn 	 tröllahvönn
Djurgårdens 	 Djurgården
Djurgården 	 Djurgårdens
Djurgården 	 Djurgårdens
felmstursköstum 	 felmtursköstum
Japönsku 	 japönsku
felmstursköstum 	 felmtursköstum
Japönsku 	 japönsku
Hardcore 	 hardcore
Frumuerfðafræði 	 frumuerfðafræði
Þolendur 	 þolendur
þolendur 	 Þolendur
Hringvía 	 hringvía
Philadelphia 	 Philadelphiu
geometric 	 Geometric
pyramid 	 Pyramid
fingerprint 	 Fingerprint
Ólía 	 Ólían
knattsborðskúlur 	 knattborðskúlur
Stundaði 	 stundaði
Samfélagsmiðlar 	 Samfélagsmiðill
sjálboðastarfi 	 sjálfboðastarfi
hátiðaljómi 	 hátíðaljómi
Evfrosyne 	 Evfrosýne
Norðurlandaráðs 	 Norðurlandaráðsþingi
Norðurlandaráðsþingi 	 Norðurlandaráðs
fyrirtækisinns 	 fyrirtækisins
Döbbsins 	 döbbsins
golíatbjalla 	 Golíatbjalla
Menntagyðjunum 	 menntagyðjunum
Nauðafágætt 	 nauðafágætt
Klukkaturn 	 Klukkuturn
klukkaturn 	 klukkuturn
Westminsterhöll 	 Westminsterhallar
Westminsterhöll 	 Westminsterhallar
Coulomb 	 coulomb
sementverksmiðjunni 	 Sementverksmiðjunni
þjórernisflokkunum 	 þjóðernisflokkunum
Íátið 	 Ílátið
maríneringu 	 maríneringar
maríneringu 	 maríneringunni
Elektronískar 	 elektronískrar
Nu-metali 	 nu-metali
nokkrum 	 Þónokkrum
Pergamon-Museum 	 Pergamonmuseum
fáliðaðasta 	 fáliðasta
ixobrychus 	 Ixobrychus
rúþensambönd 	 rútensambönd
Sovét-tímabilinu 	 Sovéttímabilinu
Verslunarráð 	 Verzlunarráð
stórsæa 	 stórsæja
Panopticon 	 panopticon
Fornsagnaþingunum 	 fornsagnaþingunum
SI-grunneining 	 grunneining
Ampere 	 Amper
Ukraínumanna 	 Úkraínumanna
Bandarísk 	 bandarísk
Seyðisfjarðargöng 	 Seyðisfjarðar
Seyðisfjarðar 	 Seyðisfjarðargöng
Seyðisfjarðargöng 	 Seyðisfjarðar
Seyðisfjarðar 	 Seyðisfjarðargöng
konsti 	 kosti
skýrlsur 	 skýrslur
Hvítþynur 	 Hvítþinur
Stundaði 	 stundaði
Pierre 	 Pierres
atomizer 	 cartomizer
clearomizer 	 cartomizer
cartomizer 	 atomizer
cartomizer 	 clearomizer
Rattati 	 Rattata
reikniskekkja 	 reikniskekkjuna
reikniskekkjuna 	 reikniskekkja
Súmerska 	 súmerska
Republikanar 	 Repúblikanar
demokrata 	 demókrata
tungunar 	 tungunnar
ósjálfrátt 	 ósjálfrát
Rousseau 	 Rousseaus
skotkonungs 	 skautkonungs
Kaupfélagið 	 Kaupfélag
Saltpétursýra 	 Saltpéturssýra
Ellismere-eyju 	 Ellesmere-eyju
Meþílfenídat 	 meþílfenídat
örvamdi 	 örvandi
tilheyging 	 tilhneiging
tákanað 	 táknað
Spænkgrænan 	 Spanskgrænan
Íslömsk 	 íslömsk
óskíska 	 oskíska
Nunavut-sjálfstjórnarhéraðinu 	 Núnavút-sjálfstjórnarhéraðinu
áfengismeðferða 	 áfengismeðferð
Flugfélags 	 Flugfélagsins
Flugfélagsins 	 Flugfélags
viðar-kassi 	 viðarkassi
skjaldarmerkið 	 Skjaldarmerkið
skjaldarmerki 	 Skjaldarmerkið
viðar-kassi 	 viðarkassi
skjaldarmerkið 	 Skjaldarmerkið
skjaldarmerki 	 Skjaldarmerkið
httpwwwgogoyokocom 	 wwwgogoyokocom
Hringsins 	 hringsins
Rings 	 Ring
Ring 	 Rings
Héraðssamband 	 Héraðssambands
Héraðssambands 	 Héraðssamband
Cure 	 Curie
vintra 	 vinstra
viðmiðunarmassa 	 viðmiðunarmassi
Mjaðmagrind 	 mjaðmagrind
mjaðmagrind 	 Mjaðmagrind
einkenninst 	 einkennist
Makedóníuog 	 Makedóníu
Innsetningarröðun 	 innsetningarröðun
Tungumál 	 tungumál
Tungumál 	 tungumál
tungumál 	 Tungumál
tungumál 	 Tungumál
«Ungverski 	 Ungverski
sósíalistaflokkurinn» 	 sósíalistaflokkurinn
uppbygginu 	 uppbyggingu
stýrikerfisins 	 OS-stýrikerfisins
ársárskrift 	 ársáskrift
jómfrúreyjar 	 Jómfrúreyjar
drenna 	 renna
Marshalláætluninnar 	 Marshalláætlunarinnar
lífverur 	 Lífverur
uppgvötaði 	 uppgötvaði
lifia 	 lifa
A-vítamínum 	 D-vítamínum
D-vítamínum 	 A-vítamínum
Framfæturnar 	 Framfæturnir
Þeramín 	 Þeremín
argobba 	 Argobba
argobba 	 Argobba
Sjóndeildarhringurinn 	 sjóndeildarhringurinn
ör-þörunga 	 örþörunga
Dactylismus 	 dactylismus
Flestir 	 flestir
Dactylismus 	 dactylismus
Flestir 	 flestir
Íþróttabandalag 	 Íþróttabandalagi
Landamærin 	 Landamæri
Landamærin 	 landamærin
suður 	 suður-
Hvítarússland 	 Hvíta-Rússland
Finland 	 Finnland
پاکستا 	 پاکستان
suður-Asíu 	 Suður-Asíu
Hljómsveitin 	 hljómsveitin
hljómsveitin 	 Hljómsveitin
Meðalstór 	 meðalstór
Schnauzer 	 schnauzer
meðalstór 	 Meðalstór
Risaschnauzer 	 risaschnauzer
‚Íslendinga 	 Íslendingar
siðaskiptinn 	 siðaskiptin
mismunanda 	 mismunandi
Borgirnar 	 borgirnar
innnanbæjar 	 innanbæjar
frumkóta 	 frumkóða
keyrslukóta 	 keyrslukóða
Ziemsen 	 Zimsen
gjaldgeri 	 gjaldkeri
innnanbæjar 	 innanbæjar
frumkóta 	 frumkóða
keyrslukóta 	 keyrslukóða
Ziemsen 	 Zimsen
gjaldgeri 	 gjaldkeri
fjallendi 	 fjalllendi
mið-Evrópu 	 Mið-Evrópu
Hveðn 	 Hven
Hven 	 Hveðn
Norðurslóðum 	 norðurslóðum
Bassaleikarinn 	 bassaleikarinn
Blossevilleströndin 	 Blossevilleströnd
Youtube 	 YouTube
stilklausog 	 stilklaus
undann 	 undan
Rósakirsiber 	 Rósakirsi
heimspekingar 	 Heimspekingar
fjöldan 	 fjöldann
laggt 	 lagt
áhugaverðir 	 Áhugaverðir
innann 	 innan
siðaskiftum 	 siðaskiptum
Evrópska 	 evrópska
Bandarísks 	 bandarísks
Bæjarbíói 	 Bæjarbíó
kvimyndasýningum 	 kvikmyndasýningum
efnsambönd 	 efnasambönd
Phyllostachys 	 phyllostachydis
phyllostachydis 	 Phyllostachys
vatnaskiljum 	 vatnaskilum
tegjast 	 tengjast
hraðsreiðasta 	 hraðskreiðasta
Indómalajavistsvæðisins 	 Indómalajasvæðisins
óhreynindum 	 óhreinindum
Auðunnar 	 Auðunar
student 	 stúdent
búddhatrúarmanna 	 búddatrúarmanna
reykingabann 	 reykingabanni
occipitial 	 occipitalis
Kínavaxblóm 	 kínavaxblóm
inn 	 inn-
útstreymisopnum 	 útstreymisopunum
hitavatnstönkunum 	 heitavatnstönkunum
eðlisfræðiverkefni 	 rafgaseðlisfræðiverkefni
Rodrigíska 	 rodrigíska
rodrigíska 	 Rodrigíska
Forseti 	 forseti
Forseti 	 forseti
sjáfarguðinn 	 sjávarguðinn
Versalir-háskóli 	 Versalaháskóli
óvinskap 	 óvinskapar
kafteinn 	 Kafteinn
Balclava 	 Balaclava
þokkagyðjurnar 	 Þokkagyðjurnar
borgarmökin 	 borgarmörkin
agnageislun 	 agnageisla
gotlenska 	 Gotlenska
sveitastjórnarkosningum 	 sveitarstjórnarkosningunum
orðabók 	 Orðabók
orðabók 	 Orðabók
ferilheildis´í 	 ferilheildis
slesísku 	 slésísku
jarðskálfta 	 jarðskjálfta
flóðbygja 	 flóðbylgja
Barnahjálp 	 Barnahjálpar
Þjóðanna 	 þjóðanna
Aðalhaskólasvæðið 	 Aðalháskólasvæðið
vesturhluta 	 suðvesturhluta
Rebúblikanar 	 rebúblikanar
Sambandssinna 	 sambandssinna
Sicilia 	 Siciliana
Kryddpíurnar 	 Kryddpíur
Transposon 	 transposon
transpose‘að 	 transpose
keynesianisma 	 keynesisma
grunnvelli 	 grundvelli
frjálslyndisstefnu 	 frjálslyndisstefnunnar
ný-frjálshyggjuna 	 nýfrjálshyggjuna
nátturunnar 	 náttúrunnar
markverdir 	 markverðir
kirkjustadinn 	 kirkjustaðinn
Búskapur 	 búskapur
búskapur 	 Búskapur
bæum 	 bæjum
Duinkerken 	 Duinkerke
plötuklædda 	 plötuklæddan
Trjáhringjafræði 	 Árhringjafræði
plötuklædda 	 plötuklæddan
Trjáhringjafræði 	 Árhringjafræði
Óskarsverðlauna 	 Óskarsverðlaun
Óskarsverðlaun 	 Óskarsverðlauna
Stundum 	 stundum
Uppgvötvanir 	 Uppgötvanir
Mikhail 	 Mikhaíl
Eysunes 	 Eisunes
tíðgast 	 tíðkast
silfuri 	 silfri
Stafnes 	 Starnes
Stafnes 	 Stapnes
Starnes 	 Stafnes
Starnes 	 Sternes
Starnes 	 Stapnes
Sternes 	 Starnes
Stapnes 	 Stafnes
Stapnes 	 Starnes
Suður-Kasakstan 	 Suður-Kasakstanfylki
forritskódann 	 forritskóðann
Stafirnir 	 stafirnir
Delgomé 	 Delgome
stafirnir 	 Stafirnir
voldemort 	 Voldemort
voldemort 	 Voldemort
afkóðari 	 afkóðar
afkóðar 	 afkóðari
afkóðar 	 afkóðari
þríhnúka 	 Þríhnúka
Dal 	 Dhal
Dhal 	 Dal
barna 	 barna-
unglingaverðlaun 	 unglingaverðlauna
Landfundatímabilið 	 landafundatímabilið
kafbátarleitarþyrla 	 Kafbátarleitarþyrlan
Stafrófið 	 stafrófið
stafrófið 	 Stafrófið
belegen 	 Belegen
Belegen 	 belegen
Belegen 	 belegen
belegen 	 Belegen
Staðsetningin 	 Staðsetning
Lands 	 Land’s
Lands 	 Land’s
Lands 	 Land’s
Lands 	 Land’s
Loftslagsbeli 	 Loftslagsbelti
sáþekkt 	 áþekkt
Ian 	 Ians
Flemmings 	 Fleming
Kraftar 	 Krafta
Kraftar 	 kraftar
Byggingameistari 	 byggingameistara
bygginameistara 	 byggingameistara
Psychedelic 	 psychedelic
hugtakið 	 Hugtakið
samlífislífverur 	 samlífislífverum
iðra 	 iðra-
húðbakteríusamfélög 	 húðbakteríusamfélögum
innanfrumusníkla 	 innanfrumusníklum
september-Nóvember 	 september-nóvember
habanero 	 Habanero
ratsjárskjáum 	 ratsjárskjám
fjrósömu 	 frjósömu
fjrósömu 	 frjósömu
deildarjöfnum 	 deildajöfnum
Kangaatsiaq 	 Kangâtsiaq
Kangâtsiaq 	 Kangaatsiaq
crab 	 crabe
Kynferðislegt 	 kynferðisleg
Kólesteról 	 kólesteról
Kólesteról 	 kólesteról
Vietnam 	 Víetnam
herkænskur 	 herkænsku
skattainheimtu 	 skattheimtu
stjórnmála 	 stjórnmála-
Tehran 	 Teheran
skráarkerfi 	 skráakerfi
Handverkfæri 	 handverkfæri
uppgufanarmálma 	 uppgufunarmálma
rússneska 	 Rússneska
Rússneska 	 rússneska
Eve’s 	 Eves
Schouten 	 Schoutens
Svartaskóginum 	 Svartaskógi
Aceton-peroxíð 	 Asetonperoxíð
forritunarmál 	 Forritunarmálið
Harrierþotur 	 Harrier-þotur
Viðreisnarstjórn 	 Viðreisnarstjórnin
Viðreisnarstjórn 	 Viðreisnarstjórnin
Garðarshólmur 	 Garðarshólmi
Hardcore 	 hardcore
Stuðningsmannasveit 	 stuðningsmannasveit
Stuðningsmannasveit 	 stuðningsmannasveitin
Handbolta 	 handbolta
Handbolta 	 handbolta
stuðningsmannasveitin 	 stuðningsmannasveit
Chicken 	 chicken
Chicken 	 chicken
Chicken 	 chicken
Chicken 	 chicken
Skotland 	 Scotland
Scotland 	 Skotland
Grænlendingasögu 	 Grænlendinga
Meltingarensím 	 meltingarensím
aðalkirkunnar 	 aðalkirkjunnar
veldingu 	 veldinu
Danmörkur 	 Danmerkur
Skeljaröðun 	 skeljaröðun
Innsetningarröðun 	 innsetningarröðun
Sprengigar 	 Sprengigígar
sjaldnarar 	 sjaldnar
Pólinesíu 	 Pólynesíu
Sthaviras 	 sthaviras
Kirkjuklukkunum 	 kirkjuklukkunum
pílagrímaleið 	 pílagrímaleiðir
röntgengeislavélar 	 röntgengeislavélum
Arabíska 	 arabíska
Bandaríkjum 	 Bandaríkjunum
Stundum 	 stundum
stundum 	 Stundum
littli 	 litli
aðalsgestasofa 	 aðalsgestastofa
littli 	 litli
aðalsgestasofa 	 aðalsgestastofa
útbreislusvæði 	 útbreiðslusvæði
Grannfræði 	 grannfræði
alsherjarskortur 	 allsherjarskortur
Alþingismaður 	 alþingismaður
Tíðnin 	 Tíðni
Neoptolemos 	 Neoptólemos
monsúnkomunnar 	 monsúnkomunni
myndinar 	 myndir
Tsjad 	 Tjad
aðferðin 	 Aðferðin
séleyfishöfum 	 sérleyfishöfum
aðfararveð 	 Aðfararveð
mýrarlerki 	 mýralerki
mýrarlerki 	 mýralerki
Veiðunum 	 Veiðum
skipstjóri 	 Skipstjóri
Vísindafélagið 	 vísindafélagið
KónulóaKrabbinn 	 Kóngulóakrabbinn
kathólskrar 	 kaþólskrar
Mousquetaires 	 mousquetaires
Antigonus 	 Antigonos
fræðimenskunnar 	 fræðimennskunnar
post-pönk 	 póst-pönk
Þróunarlöndum 	 þróunarlöndum
almnningi 	 almenningi
Austur-Kasakstan 	 Austur-Kasakstanfylki
meginn 	 megin
tpvo 	 tvo
Sjálfstæðisflokkinum 	 Sjálfstæðisflokknum
Kanadískur 	 kanadískur
Sovíetríkjunum 	 Sovétríkjunum
aleutíska 	 aleútíska
tvem 	 tveim
tvem 	 tveim
Sóknanefnd 	 Sóknarnefnd
athugandann 	 athuganda
rafsegulsgeislun 	 rafsegulgeislun
lögunbum 	 lögunum
Verslanir 	 Verslanirnar
drógst 	 dróst
heimstryjöldina 	 heimstyrjöldina
rússneska 	 Rússneska
stýrimæður 	 stýrimaður
ribbung 	 ribbungar
ribbungar 	 ribbung
frönsum 	 frönskum
kaupmáttarjöfnuði 	 kaupmáttarjöfnuð
Mirageþoturnar 	 Mirage-þoturnar
Harrierþoturnar 	 Harrier-þoturnar
Mirageþotuna 	 Mirage-þotuna
frjálslyndishugmyndir 	 frjálslyndishugmyndum
frjálslyndishugmyndir 	 frjálslyndishugmyndum
viljastýrð 	 viljastýrt
snýkudýrið 	 sníkjudýrið
rússneska 	 Rússneska
Rússneska 	 rússneska
armönskum 	 armenskum
armönsk 	 armensk
Maðurinn 	 maðurinn
Maguires’’ 	 Maguires
Rafmagnsbíll 	 rafmagnsbíll
lifrustiginu 	 lirfustiginu
færeyjar 	 Færeyjar
aðflutur 	 aðfluttur
dom 	 doom
doom 	 dom
umhverfisþrýsting 	 umhverfisþrýstingi
Skógaströnd 	 Skógarströnd
yfirskrifar 	 yfirskrifast
Jangste 	 Jangtse
Amazonfljótinu 	 Amasónfljótinu
vinnuhringur 	 Vinnuhringur
Wikimedia 	 Wikipedia
Wikipedia 	 Wikimedia
Wikipedia 	 Wikimedia
WikiMedia 	 Wikimedia
WikiMedia 	 Wikipedia
WikiMedia 	 Wikimedia
Úranusi 	 Úranosi
Engjasnigill 	 engjasnigill
Möskvasnigill 	 möskvasnigill
Mýrasnigill 	 mýrasnigill
sýndarveruleikin 	 sýndarveruleikinn
frammúrskarandi 	 framúrskarandi
bandaríkjamarkaði 	 Bandaríkjamarkaði
ákvarðatöku 	 ákvarðanatöku
fjallakeðjunnar 	 Shan-fjallakeðjunnar
bylltingakennd 	 byltingakennd
læknisfræði 	 læknisfræðirit
Samheiti 	 samheiti
Argosarfara 	 Argóarfara
vulgariser 	 vulgaris
Rasspútín 	 Raspútín
Raspútín 	 Rasspútín
rúþenoxíði 	 rútenoxíði
Vetrarstríðsins 	 vetrarstríðsins
Úlfhams 	 Úlfhami
Úlfhami 	 Úlfhams
hebreiska 	 hebreska
semitískum 	 semískum
Festingar 	 festingar
festingar 	 Festingar
Danskrar 	 danskrar
Progressive 	 progressive
Progressive 	 progressive
Winsor 	 Windsor
Hafsins 	 hafsins
koffeinríkur 	 koffínríkur
Kat 	 Khat
matarlist 	 matarlyst
geimsluhólf 	 geymsluhólf
Tegundin 	 tegundin
langningu 	 lagning
Frakklandskeisara 	 Frakkakeisara
Josephine 	 Joséphine
Norður-Kasakstan 	 Norður-Kasakstanfylki
Nuremberg-réttarhöldin 	 Nürnberg-réttarhöldin
rafseglulkraf 	 rafseglulkraft
fríðartíma 	 fríðartímum
fræðitilgátuformi 	 fræðitilgátur
þrysting 	 þrýsting
fenjakrókudíllinn 	 fenjakrókódíllinn
finnó-úgrískra 	 finnsk-úgrískra
Karpata-fjöll 	 Karpatafjöll
skólan 	 skólann
skólan 	 skólann
skólan 	 skólann
skólan 	 skólann
fenjakrókudíllinn 	 fenjakrókódíllinn
finnó-úgrískra 	 finnsk-úgrískra
Karpata-fjöll 	 Karpatafjöll
skólan 	 skólann
skólan 	 skólann
skólan 	 skólann
skólan 	 skólann
náttúrnni 	 náttúrunni
svartann 	 svartan
enn 	 Menn
Octaviu 	 Octavíu
uppskar 	 Uppskar
aflfæði 	 aflfræði
Íþróttir 	 íþróttir
Körfuknattleikur 	 körfuknattleikur
Knattspyrna 	 knattspyrna
Frjálsar 	 frjálsar
íþróttir 	 Íþróttir
Siglingar 	 siglingar
ókyrðin 	 ókyrrðin
Trotskí 	 Trotskíj
Trotskí 	 Trotskíj
Ljev 	 Lev
Ljev 	 Lev
Ljev 	 Lev
Ljev 	 Lev
Ljev 	 Lev
Ljev 	 Lev
ryþmablús 	 Ryþmablús
samningar 	 Samningar
Vágar 	 Vága
mahayana 	 mahajana
flokkræði 	 flokksræði
duttlungafylltri 	 duttlungafyllri
Bleikja 	 bleikja
heimskautableikja 	 Heimskautableikja
áNorðurslóð 	 Norðurslóðum
Múhammeð 	 Múhammeðs
Fjölbrautarskólanum 	 Fjölbrautaskóla
fólks- 	 fólks
danmerkur 	 Danmerkur
Hafnarháskólan 	 Hafnarháskóla
eyjahafinu 	 Eyjahafinu
Lemno 	 Lemnos
Heimstyrjöldinni 	 heimsstyrjöldinni
Japönsku 	 japönsku
Japönsku 	 japönsku
sjálfstæðisflokksins 	 Sjálfstæðisflokksins
geðveikismálið 	 geðveikismál
Gagnfræðaskólann 	 Gagnfræðaskóla
Gagnfræðaskólann 	 Gagnfræðaskóli
Gagnfræðaskóli 	 Gagnfræðaskóla
Meltingarkerfið 	 meltingarkerfið
meltingarkerfið 	 Meltingarkerfið
búlgara 	 Búlgara
austur-vígstöðvarnar 	 austurvígstöðvarnar
Samfélag 	 samfélag
viðskipta 	 viðskipta-
Fordism 	 Fordismi
Einkennist 	 einkennist
Fordism 	 Fordismi
Einkennist 	 einkennist
Atlandshafi 	 Atlantshafi
hefbundnir 	 hefðbundnir
Hindúisma 	 hindúisma
Búddisma 	 búddisma
samstepystjórn 	 samsteypustjórn
skrölorm 	 skröltorm
bifhlól 	 bifhjól
Drómetari 	 Drómedari
Jökullsson 	 Jökulsson
Special´´ 	 Special
Special´´ 	 Special
LÍbanon 	 Líbanon
victoria 	 Victoria
Hraðinn 	 hraðinn
hröðunin 	 hröðinin
hraðinn 	 Hraðinn
hröðinin 	 hröðunin
hröðinin 	 hröðunin
konungssambanda 	 konungssamband
fersentimeter 	 fersentimetri
málmunga 	 málmungar
málmungar 	 málmunga
þekkingargrunnur 	 þekkingargrunnurinn
þekkingargrunnurinn 	 þekkingargrunnur
skurðahnífar 	 skurðarhnífar
Tønsberg 	 Túnsberg
Túnsberg 	 Tønsberg
Upsaströnd 	 Ufsaströnd
Ufsaströnd 	 Upsaströnd
Jörðinni 	 jörðinni
Persnesku 	 persnesku
Aðalbláberjalyng 	 aðalbláberjalyng
Aðalbláberjalyng 	 bláberjalyng
Humboldt 	 Humboldts
Humboldts 	 Humboldt
Sovíetmanna 	 Sovétmanna
Sovíetríkin 	 Sovétríkin
bílakjallaranum 	 bílakjallara
bílakjallaranum 	 bílakjallara
Dom 	 Domi
Domi 	 Dom
lággjaldaflugfélögum 	 lággjaldaflugfélög
næringafræði 	 næringarfræði
sálfræðarnnar 	 sálfræðinnar
Þallarætt 	 þallarætt
stofnfrumur 	 stofnfrumurnar
stofnfrumurnar 	 stofnfrumur
Skanskapakkhúsinu 	 Skansapakkhúsinu
Þorsteidn 	 Þorsteinn
kjemur 	 kemur
bretton 	 Bretton
Nunavut-sjálfstjórnarhéraðinu 	 Núnavút-sjálfstjórnarhéraðinu
Neðra-Saxland 	 Neðra-Saxlands
Neðra-Saxland 	 Neðra-Saxlands
atferlis 	 atferlis-
lögjafaþingi 	 lögjafarþingi
Íslenzka 	 íslenzka
Bókmenntafélagi 	 bókmenntafélagi
Kenning 	 kenning
bylinguna 	 byltinguna
nikkólít 	 nikkólíti
gersdorffíti 	 gersdorfíti
Drauminn 	 Draumurinn
frumuskiftingu 	 frumuskiptingu
Wallis- 	 Wallis
Wallis 	 Wallis-
Egypsku 	 egypsku
serbo-króatísku 	 serbókróatísku
byggingaaðferðum 	 byggingaaðferða
byggingaaðferðum 	 byggingaaðferða
vesturveldin 	 Vesturveldin
hefr 	 hefur
Holsetuland 	 Holtsetaland
Sambandssinna 	 sambandssinna
dreyfir 	 dreifir
hásteins 	 Hásteins
hástein 	 Hástein
Allherjarþing 	 Allsherjarþing
sameinuðu 	 Sameinuðu
margsinnið 	 margsinnis
bandaríkjamenn 	 Bandaríkjamenn
gítar-sóló 	 gítarsóló
Ómanflói 	 Ómanflóa
Tacítus 	 Tacitus
guðii 	 guði
anstæðunni 	 andstæðunni
anstæðunni 	 andstæðunni
Náttúrufræðinginn 	 Náttúrufræðingnum
islandicaer 	 islandica
sand 	 sand-
temruðum 	 tempruðum
reiknrit 	 reiknirit
reiknrit 	 reiknirit
Sólk 	 Sól
hljóðfær 	 hljóðfæri
Smalamáls 	 smalamáls
skipanir 	 Skipanir
Aristótelisi 	 Aristótelesi
Vísitala 	 vísitala
vísitala 	 Vísitala
Birg­ir 	 Birgir
fædd­ist 	 fæddist
Reykja­vík 	 Reykjavík
son­ur 	 sonur
Sig­urðar 	 Sigurðar
Helga­son­ar 	 Helgasonar
mynd­list­ar­manns 	 myndlistarmanns
sjó­manns 	 sjómanns
Friðbjarg­ar 	 Friðbjargar
Jóns­dótt­ur 	 Jónsdóttur
hús­móður 	 húsmóður
Flórida 	 Flórída
stofnananda 	 stofnanda
hryndjanda 	 hrynjanda
straum–laxinn 	 straumlaxinn
sjó–laxinn 	 sjólaxinn
grútarlampi 	 grottarlampi
Genisis 	 Genesis
suðvestur 	 suðvestur-
bandaríkjaforseti 	 Bandaríkjaforseti
þessarra 	 þessara
ameríku 	 Ameríku
eiginleikia 	 eiginleika
Mónikubrú 	 Monikubrú
Andosol 	 andosol
Brandenborg 	 Brandenburg
Brandenburg 	 Brandenborg
Bramborska 	 Braniborska
Braniborska 	 Bramborska
félagsþjónustu 	 félagsþjónusta
ska 	 skal
mekir 	 merkir
ofstast 	 oftast
annari 	 annarri
Heimsins 	 heimsins
foseti 	 forseti
kastalan 	 kastalanum
Taóismi 	 daóismi
Taóismi 	 taóismi
Daóismi 	 Daoismi
Daóismi 	 daóismi
Daóismi 	 taóismi
Geimferðastofnun 	 geimferðastofnun
geimferðarstofnun 	 Geimferðastofnun
geimferðarstofnun 	 geimferðastofnun
Mystic 	 Mystical
sjónframsetningu 	 framsetningu
áratug 	 áratugs
áratugs 	 áratug
sameinigu 	 sameiningu
Hátalara 	 Hátalari
Kaereas 	 Kaereasar
Kallirrhoe 	 Kallirhoe
Miðjuflokksins 	 Miðflokksins
Norður-Atlantshafið 	 Norður-Atlantshafi
Regensburg 	 Regensburger
Regensburg 	 Regensburger
sameinginleg 	 sameiginleg
norðurlöndunum 	 Norðurlöndunum
kvikuþrýstingurinn 	 kvikuþrýstingur
inninheldur 	 inniheldur
Steingervinga 	 Steingervingar
Machairodontinae 	 machairodontinae
léka 	 lék
einning 	 einnig
Venezúela 	 Venesúela
Dulkornótt 	 dulkornótt
Júpiters 	 Júpíters
Turninn 	 turninn
Turninn 	 turninn
felmstursraskana 	 felmtursraskana
felmstursraskana 	 felmtursraskana
Stundaði 	 stundaði
Jarðskjálftafræði 	 skjálftafræði
Konungur 	 konungur
Konungur 	 konungur
Bretzelborg 	 Bretzelburg
Bretzelburg 	 Bretzelborg
kvikmyndaleikstjóri 	 kvikmyndaleikstjórii
Sjálfróunarmúffa 	 Sjálfsfróunarmúffa
skattarannsókna 	 skattrannsókna
t-Eilean 	 Eilean
Eilean 	 t-Eilean
Республика 	 Республикасы
tatarísku 	 tataríska
Республикасы 	 Республика
Rússneska 	 rússneska
Tilskipanir 	 tilskipanir
tálknaröðinni 	 tálknaröðina
Villisvín 	 villisvín
villisvín 	 Villisvín
Stóru-Sundaeyjar 	 Stóru-Sundaeyjum
Apple-tölvar 	 Apple-tölvur
tvenndarleik 	 tvendarleik
veiðuna 	 veiðina
úrvaldeilinni 	 úrvalsdeildinni
deildarinna 	 deildarinnar
Cantor 	 Cantors
Volterra 	 Volterras
Arzelà 	 Arzelàs
Hadamard 	 Hadamards
Ascoli 	 Ascolis
fliðrúm 	 firðrúm
eldsneyti 	 Lífeldsneyti
Sambíóum 	 Sambíóunum
TPA 	 KTPA
KTPA 	 TPA
gleðiskapur 	 gleðskapur
breitingar 	 breytingar
myndarinar 	 myndarinnar
Berenikuhaddur 	 Bereníkuhaddur
undirsporbrautarflugum 	 undirsporbrautarflugi
Hjónaband 	 hjónaband
hjónaband 	 Hjónaband
samtakahyggju 	 samtakahyggjan
peróna 	 persóna
perónuna 	 persónuna
gúmmívörum 	 gúmmívörur
Húmgapar 	 húmgapar
Tromlan 	 tromlan
tromlan 	 Tromlan
Jómfrúaeya 	 Jómfrúaeyja
einig 	 einnig
leikjafamleiðundum 	 tölvuleikjafamleiðundum
stimlað 	 stimplað
Jefferson 	 Jeffersons
Burns 	 Burn
plasbarki 	 plastbarki
Rutherfordín 	 rutherfordín
Rutherfordín 	 Rutherford
kjarneðlisfræðingi 	 kjarneðlisfræðing
Ein 	 Einn
Fangavaktin 	 Fangavaktinni
aðalega 	 aðallega
Bifrost 	 Bifröst
Bifröst 	 Bifrost
Abelsverðlaunin 	 Abelverðlaunin
Atlandshafi 	 Atlantshaf
Atlandshaf 	 Atlantshaf
Københavns 	 København
Hovedbanegård 	 Hovedbanegården
København 	 Københavns
Hovedbanegården 	 Hovedbanegård
aðaljárnbrautarstöðin 	 Aðaljárnbrautastöðin
Venjulega 	 venjulega
stærðfræðiferilinn 	 stærðfræðiferil
ádeilanleg 	 umdeilanleg
Klassísk 	 klassísk
Raftónlist 	 raftónlist
Framsækið 	 framsækið
Sýrurokk 	 sýrurokk
Nýbylgjutónlist 	 nýbylgjutónlist
Mælieining 	 mælieining
heiranlega 	 heyranlega
Bandalags 	 Bandalagi
forustustuðullinn 	 forystustuðullinn
forustustuðul 	 forystustuðul
Miðaldargálgar 	 Miðaldagálgar
slagverkshljóðfærum 	 slagverkshljóðfæra
vígslubiskup 	 Vígslubiskup
Flugvöllur 	 flugvöllur
IAD 	 KIAD
KIAD 	 IAD
stjörnufræði 	 stjörnufræðinámi
Akhenaten 	 Akenaten
Þoskafjarðaheiði 	 Þoskafjarðarheiði
Beta-karótíns 	 betakarótíns
Glýseróls 	 glýseróls
Dopplerhrif 	 dopplerhrif
Reykjavik 	 Reykjavík
geislaveiki 	 geislavirkni
geislvirkni 	 geislavirkni
Chianti-víni 	 Chinti-vín
Plíósene 	 Plíósen
Aviv-Yafo 	 Avív-Yafo
miðjarðarhafsins 	 Miðjarðarhafsins
ömmuferningur 	 ömmuferningum
Flugfélag 	 flugfélag
Flugfélag 	 Flugfélags
Íslenskt 	 íslenskt
flugfélag 	 Flugfélag
Flugfélags 	 Flugfélag
Synister 	 Synyster
fornarldarsögur 	 fornaldarsögur
Ósíríss 	 Ósíriss
stjórnmiðstöð 	 stjórnstöð
stjórnmiðstöð 	 stjórnstöð
Fyrirhugað 	 fyrirhugað
Lansvirkjun 	 Landsvirkjun
Ladejarle 	 Ladejarlene
Ladejarle 	 Ladejarlane
Ladejarlane 	 Ladejarlene
stefnan 	 Stefnan
sjálstætt 	 sjálfstætt
Aserbaidsjan 	 Aserbaídsjan
Quixote 	 Quijote
dromaius 	 Dromaius
ófleyhir 	 ófleygir
Fennikka 	 fennikka
Fennikka 	 fennikka
Grindhvalur 	 Grindhvalir
Anakondu 	 anakondu
Anakonduna 	 anakonduna
fórnarlambana 	 fórnarlambanna
Júra-fjöllum 	 Júrafjöllum
Narsarmijit 	 Narsarmiit
Narsarmiit 	 Narsarmijit
Skotland 	 Scotland
Leikurinn 	 leikurinn
leikurinn 	 Leikurinn
tímann 	 tímannn
norðurlöndum 	 Norðurlöndum
heila- 	 heila
heila 	 heila-
vefþjónustu 	 vefþjónustur
Filippeysku 	 filippeysku
Jörðinni 	 Jörðin
Jörðin 	 Jörðinni
Jörðinni 	 Jörðin
Jörðin 	 Jörðinni
krókudílar 	 krókódílar
Akeroya 	 Akerøya
Ljónshjarta 	 ljónshjarta
Galbraith 	 Galbraiths
Knattspyrnufélag 	 Knattspyrnufélags
Knattspyrnufélag 	 Knattspyrnufélagsins
Knattspyrnufélags 	 Knattspyrnufélag
Knattspyrnufélags 	 Knattspyrnufélagsins
Knattspyrnufélagsins 	 Knattspyrnufélag
Knattspyrnufélagsins 	 Knattspyrnufélags
bandaríkjaforseta 	 bandaríkjaforseti
stykt 	 styrkt
Landádalsströnd 	 Langadalsströnd
myndarlegasem 	 myndarlega
stórsæa 	 stórsæja
hjálpahunar 	 hjálpahundar
Deltafallið 	 Deltufallið
Deltufall 	 Deltufallið
landafræðislega 	 landafræðilegri
stærðfræðiaðferð 	 stærðfræðiaðgerð
stærðfræðiaðferð 	 stærðfræðiaðgerð
hljómskálagarðinum 	 Hljómskálagarðinum
Miklartorgs 	 Miklatorgs
skólan 	 skólann
samnendri 	 samnefndri
Dagurinn 	 dagurinn
dagurinn 	 Dagurinn
eSouth 	 South
prónum 	 prjónum
Matarprónarlöndunum 	 Matarprjónalöndunum
landshlutinum 	 landshlutanum
Middlesborough 	 Middlesbrough
bláleitann 	 bláleitan
Hugsunin 	 hugsunin
stærðfræðiaðferð 	 stærðfræðiaðgerð
Sindbað 	 Hindbað
Sindbað 	 Hindbað
Hindbað 	 Sindbað
Hindbað 	 Sindbað
Miðjaðarhafið 	 Miðjarðarhafið
austurskagans 	 suðausturskagans
austurskagans 	 suðausturskagans
austur 	 austur-
suður 	 suður-
málfræðingurinn 	 Málfræðingurinn
oriðið 	 orðið
oriðið 	 orðið
oriðið 	 orðið
oriðið 	 orðið
Arababandalaginu 	 Arababandalagsins
Stafhotstunguhreppur 	 Stafholtstungnahreppur
Forsetinn 	 Forseti
forseti 	 Forseti
Hugtakið 	 hugtakið
hugtakið 	 Hugtakið
Forsetinn 	 Forseti
forseti 	 Forseti
Hugtakið 	 hugtakið
hugtakið 	 Hugtakið
Greinamun 	 Greinarmun
núlíðnandi 	 núlíðandi
fyrirslestraraðir 	 fyrirlestraraðir
fyrirslestraraðir 	 fyrirlestraraðir
skipulagaðar 	 skipulagðar
Ryþmablús 	 ryþmablús
Asískur 	 asískur
Deskattarætt 	 deskattaætt
víetnamstríðið 	 Víetnamstríðið
Norður-Ameríkhu 	 Norður-Ameríku
Flensborg 	 Flensburg
Flensborg 	 Flensborag
Flensburg 	 Flensborg
Flensburg 	 Flensborg
Flensborg 	 Flensburg
Flensborg 	 Flensborag
Flensburg 	 Flensborg
Flensburg 	 Flensborg
pólísk 	 pólitísk
hitaaukning 	 hitaukning
Selsíus 	 selsíus
°Cm 	 °Ckm
°Ckm 	 °Cm
Arabíska 	 arabíska
Múhameðstrúarmanna 	 múhameðstrúarmanna
höfuðtala 	 Höfuðtala
varnarmálaráðuneytis 	 Varnarmálaráðuneytis
bandaríkjana 	 Bandaríkjana
kjarnorku 	 kjarnorku-
forn-Grikkja 	 Forn-Grikkja
Shakespeare 	 Shakespeares
Skólakór 	 skólakór
Færæyjar 	 Færeyjar
líkamslegt 	 líkamlegt
grá-blár 	 gráblár
svart-blár 	 svarblár
plebeirarnir 	 plebeiarnir
rokkabillí 	 rokkabillís
Sambad 	 Samband
Sambad 	 Samband
Sambandið 	 Samband
Sambandið 	 Samband
NNorður-Evrópu 	 Norður-Evrópu
Tundurstyrtla 	 Tundurstirtla
Fæðan 	 Fæða
Fossgvoginn 	 Fossvoginn
botninumHann 	 botninnHann
Floshól 	 Floshóli
GNU 	 GNUs
GNUs 	 GNU
GNUs 	 GNU
GNU 	 GNUs
GNU 	 GNUs
GNUs 	 GNU
GNUs 	 GNU
GNU 	 GNUs
Accidentals 	 accidental
the 	 them
the 	 them
them 	 the
them 	 the
them 	 the
the 	 them
Neanderdalsmönnum 	 neanderdalsmönnum
sorbitol 	 sorbitól
brenntu 	 brenndu
Tertullian 	 Tertullianus
Polykarp 	 Polykarpos
Þingeyrarklaustur 	 Þingeyraklaustur
makedóníumenn 	 Makedóníumenn
indverjar 	 Indverjar
mikin 	 mikinn
hofróðulegur 	 hofróðulegt
Karlalandsliðið 	 karlalandsliðið
huggðist 	 hugðist
markmiö 	 markmið
huggðist 	 hugðist
markmiö 	 markmið
sjalgæft 	 sjaldgæf
Geirangri 	 Geirangur
hundruði 	 hundruð
viskerfum 	 vistkerfum
mikilfenglri 	 mikilfenglegri
rokke 	 rokk
rokke 	 rokk
alvarlegart 	 alvarlegar
Skyndibitar 	 skyndibita
mishollir 	 mishollur
stafýlókokkar 	 Stafýlókokkar
Viðskeyti 	 viðskeyti
viðskeyti 	 Viðskeyti
Ólík 	 Ólíkt
sérstafsetningareglur 	 stafsetningarreglur
Borgarfjarður 	 Borgarfjarðar
browser 	 Browser
vaxtarmunaviðskipti 	 vaxtarmunarviðskipti
hænsnabúsins 	 hæsnabúss
Latínan 	 latínan
Staðgöngustríð 	 staðgöngustríð
meislingasótt 	 mislingasótt
mislingasótt 	 meislingasótt
mislingasótt 	 mislitasótt
mislitasótt 	 mislingasótt
Norðvestur-Ródesíu 	 Norðaustur-Ródesíu
Filipseyjum 	 Filippseyjum
aðalnotagildi 	 Aðalnotagildi
Sebrahestar 	 sebrahestar
sebrahestar 	 Sebrahestar
læknng 	 lækning
umhverfissamtökin 	 Umhverfissamtökin
Periodontitis 	 periodontitis
alþýðulýðveldinu 	 Alþýðulýðveldinu
Bangladesh 	 Bangladess
Háskólann 	 háskólann
Háskólann 	 háskólann
camelus 	 Camelus
einhveru 	 einhverju
matarræði 	 mataræði
Draw 	 EDraw
EDraw 	 Draw
Draw 	 EDraw
EDraw 	 Draw
Ignatiusi 	 Ignatius
Wojciech 	 Wojciechs
tónlistaverðlaun 	 tónlistarverðlaun
Orrustuskip 	 orrustuskip
Orrustuskip 	 orrustuskip
Gufuknúin 	 gufuknúin
Khamitov 	 Khamitova
Khamitova 	 Khamitov
Han 	 Hans
frelsisbjöllunni 	 Frelsisbjöllunni
frelsisbjölluna 	 Frelsisbjölluna
Fibbonacci 	 Fibonacci
Stærðfræðilegir 	 Stærðfræðilegur
hálsnum 	 hálsinum
þemótvægisaðgerðir 	 mótvægisaðgerðir
Fyri 	 Fyrir
einning 	 einnig
etrúskíska 	 etrúskneska
Fóstureyðing 	 fóstureyðingu
fóstureyðingu 	 Fóstureyðing
Vipère-fyrirtækið 	 Viper-fyrirtækið
Trappert 	 Tappert
langdysjur 	 langdysjar
hundað 	 hundrað
Súez-skurðinn 	 Súesskurðinn
Skálhlolsbikups 	 Skálholtsbiskups
Myndlistardeild 	 myndlistardeild
rannsóknar 	 rannsóknar-
Siglingarstofnunar 	 Siglingastofnunar
drottingar 	 drottningar
Menorca 	 Menorka
staðartölvunni 	 staðartölvu
Grímstaðaholt 	 Grímsstaðaholt
Angusta 	 Augusta
Augusta 	 Angusta
demokrataflokksins 	 Demókrataflokksins
grugg-sveitirnar 	 gruggsveitirnar
Anakondan 	 anakondan
curvelet 	 Curvelet
spherical 	 Spherical
data-mining 	 Data-mining
calendars 	 Calendars
projectile 	 Projectile
efnahags 	 efnahags-
Burgund-héraði 	 Búrgúnd-héraði
Hafnarborgina 	 hafnarborgina
piscatoriuser 	 piscatorius
Sameignarstefna 	 sameignarstefna
Theravada-búddisma 	 theravada-búddisma
Íslensku 	 íslensku
skoðannir 	 skoðanir
skoðannir 	 skoðanir
Händels 	 Händel
hákarlategund 	 hákarlategundir
sprenigingu 	 sprengingu
drefiðist 	 dreifðist
sjálfstýru 	 sjálfstýrðu
Háþrýstigufan 	 lágþrýstigufan
lágþrýstigufan 	 Háþrýstigufan
endurnýja 	 endunýja
endunýja 	 endurnýja
Han 	 Hans
Traktor 	 Tractor
Traktor 	 traktor
Traktor 	 Tractor
Traktor 	 traktor
traktor 	 Traktor
Vanatrú 	 vanatrú
vegabréfasambönd 	 vegabréfasambandið
vegabréfasambandið 	 vegabréfasambönd
Wi-Fi 	 WiFi
Wi-fi 	 Wifi
WiFi 	 Wi-Fi
Wifi 	 Wi-fi
WLANs 	 WLAN
Hljómsveitin 	 hljómsveitin
vistarberum 	 vistarverum
demokratar 	 demókratar
heimssambandi 	 Heimssambandi
samhegislausu 	 samhengislausu
Árangur 	 árangur
árangur 	 Árangur
Jörðina 	 jörðina
Sonasonur 	 Sonarsonur
Japanska 	 japanska
Kóreska 	 kóreska
norðaustur 	 norðaustur-
rafstaum 	 rafstraum
Strandfaraskip 	 Strandfaraskipum
landsins 	 Landsins
björgun 	 Björgun
spaghettí 	 spaghetto
spaghetti 	 spaghetto
spaghetto 	 spaghettí
spaghetto 	 spaghetti
kísiller 	 kísill
ADSL 	 DSL
DSL 	 ADSL
blábakteríur 	 bakteríur
bakteríur 	 blábakteríur
annari 	 annarri
dansstíls 	 dansstíll
götudansstíls 	 götudansstíll
varðveitngu 	 varðveitingu
mið 	 mið-
Ærumeiðing 	 Ærumeiðingar
Einstaklingur 	 einstaklingur
Tagalog 	 tagalog
Tagailog 	 tagailog
Ákveðinn 	 ákveðinn
Þýðingaminni 	 Þýðingarminni
kyrrahafið 	 Kyrrahafið
Dómitíanus 	 Dómitíanusi
conjunctivitis 	 Conjunctivitis
Fenjakrókudíll 	 Fenjakrókódíll
Persneski 	 persneski
krókudíllinn 	 krókódíllinn
krókudílategund 	 krókódílategund
þríhirningum 	 þríhyrningum
Fenjakrókudíll 	 Fenjakrókódíll
Persneski 	 persneski
krókudíllinn 	 krókódíllinn
krókudílategund 	 krókódílategund
þríhirningum 	 þríhyrningum
ogSuðurgötu 	 Suðurgötu
endurnýtanlega 	 endurnýtanlegar
endurnýtanlegt 	 endurnýtanlega
endurnýtanlegt 	 endurnýtanlegar
skibshræ 	 skipshræ
tankskibið 	 tankskipið
Fáfnisbani 	 Fáfnisbana
Wayne´s 	 Waynes
superstition 	 Superstition
Tamarind 	 Tamarindus
Tamarindus 	 Tamarind
tíbetskir 	 tíbeskir
hip 	 hipp
hip 	 hipp
hip 	 hipp
hip 	 hipp
lyfsins 	 lyfsins–-
yfirkjörstjórnir 	 Yfirkjörstjórnir
þrívegur 	 Þrívegur
sambandsríkisins 	 Sambandsríkisins
mikin 	 mikinn
Hæstiréttur 	 hæstiréttur
hæstiréttur 	 Hæstiréttur
Bandarískur 	 bandarískur
meistaradeild 	 Meistaradeild
óneitanelga 	 óneitanlega
Pamplona 	 Pamplóna
Pamplona 	 Pamplóna
lífveruru 	 lífverur
Jörðunni 	 Jörðinni
veggum 	 veggjum
veggum 	 veggjum
veggum 	 veggjum
veggum 	 veggjum
Áfengistengd 	 áfengistengd
Dementia 	 dementia
grókólfhirsla 	 kólfhirsla
Theatre 	 Theater
republikanaflokkurinn 	 Repúblikanaflokkurinn
Menningarbyltingunni 	 menningarbyltingunni
Piccadilly-leiðinni 	 Piccadilly-leið
Breskur 	 Bresku
Banffþjóðgarðsins 	 Banffþjóðgarðinn
Flugvöllur 	 flugvöllur
Flugvöllur 	 flugvöllur
mikilvægt 	 Mikilvægt
Han 	 Hans
Marþöll 	 marþöll
hittitísku 	 hittísku
Humes 	 Hume
Frumuskipting 	 frumuskiptingu
frumuskiptingu 	 Frumuskipting
Frumuskipting 	 frumuskiptingu
frumuskiptingu 	 Frumuskipting
marjúana 	 marijúana
Emmanuels 	 Emmanúels
Nyasalands 	 Nýasalands
Rannsóknaraðferð 	 rannsóknaraðferðar
rannsóknaraðferðar 	 Rannsóknaraðferð
ævintýraheimaum 	 ævintýraheimum
Vinsæll 	 vinsæll
Wagner-tónhstarhátíðarinnar 	 Wagner-tónlistarhátíðarinnar
Stagbrú 	 stagbrú
mjólkura- 	 mjólkur-
brauðvaradeildum 	 brauðdeildum
hljómplatnaog 	 hljómplatna
frumefnana 	 frumefnanna
náttúrinni 	 náttúrunni
O´Donnell 	 ODonnell
Repúblikana 	 repúblikana
Grannfræðileg 	 grannfræðileg
grannfræðileg 	 Grannfræðileg
mótannir 	 mótanir
dykkjarker 	 drykkjarker
efnishyggjunar 	 efnishyggjunnar
Háskóli 	 Háskólinn
rannsóknarháskóla 	 rannsóknaháskóla
Háskólinn 	 Háskóli
Repúblikanar 	 repúblikanar
York-háskólanum 	 York-háskólann
Corsica 	 Còrsica
Marbendli 	 marbendli
Markaðsvæðing 	 markaðsvæðing
viðskiptafræðilega 	 viðskiptafræðileg
Bolivíu 	 Bólivíu
fyrverandi 	 fyrrverandi
Genisis 	 Genesis
Afstæðiskenning 	 Afstæðiskenningin
keðjun 	 keðju
keðju 	 keðjun
Politicheskoye 	 politicheskoye
Upravlenie 	 upravlenie
samtíðalýsingu 	 samtíðarlýsingu
leggangaþurrka 	 leggangaþurrki
aðalega 	 aðallega
notendur 	 X-notendur
Jouvenels 	 Jouvenel
Jouvenel 	 Jouvenels
fingrabrettið 	 fingrabrettinu
hálssins 	 hálsins
fingrabrettið 	 fingrabrettinu
hálssins 	 hálsins
forritnarmálinu 	 forritunarmálum
forritnarmálinu 	 forritunarmálunum
forritnarmálinu 	 forritunarmálinu
Aðferðin 	 Aðferðina
annrs 	 annars
Mítlaheilabólga 	 mítlaheilabólga
Landsframleiðsla 	 landsframleiðsla
spila 	 sphila
sphila 	 spila
hlífðarglerauguef 	 hlífðargleraugu
Íslensku 	 íslensku
drottnunarreikniritum 	 drottnunarreiknirit
drottnunarreiknirit 	 drottnunarreikniritum
Brandenburgarhliðið 	 Brandenborgarhliðið
Járn-þríhyrningurinn 	 Járnþríhyrningurinn
hryggningarslóðir 	 hrygningarslóðir
þúsundra 	 þúsunda
persónueiginleika 	 persónueiginleikum
Information 	 information
information 	 Information
Ceasars 	 Caesars
Murmansk 	 Múrmansk
Murmansk-fylki 	 Múrmansk-fylki
upplýsinga- 	 upplýsingar
upplýsingar 	 upplýsinga-
Norðurlöndunumþá 	 Norðurlöndunum
Xenofons 	 Xenofon
þjóðréttarsamningi 	 Þjóðréttarsamningur
aðiliar 	 aðilar
hreppurinn 	 Hreppurinn
Bosnía 	 Bosna
Bosnía 	 Bosna
forn-enska 	 fornenska
english 	 English
Engilsaxneska 	 engilsaxneska
Germönsku 	 germönsku
Línusar 	 Línosar
Oiagros 	 Ojagros
Slésvíkur-Holsetalands 	 Slésvíkur-Holtsetalands
Kobe-jarðskjálftinn 	 Kóbe-jarðskjálftinn
háspennusnerta 	 háspennusnertur
Tadsjikistan 	 Tadsíkistan
tadsjikíska 	 tadsikíska
aftýrt 	 afstýrt
fljótiu 	 fljótinu
berbaþjóðir 	 Berbaþjóðir
túaregar 	 Túaregar
and-grugg 	 andgrugg
Kalvínistum 	 kalvínistum
Pompidu 	 Pompidou
Newtons 	 Newton
elisfræðilögmál 	 eðlisfræðilögmál
Newton 	 Newtons
gripörmonum 	 gripörmunum
marglitturnar 	 marglytturnar
heimstyrjöld 	 heimsstyrjöld
Sviðsnafn 	 sviðsnafn
austur 	 austur-
suðaustur 	 suðaustur-
Ráðstefna 	 ráðstefna
ráðstefna 	 Ráðstefna
skartgripi 	 Skartgripir
Gítarleikari 	 gítarleikari
Píanóleikari 	 píanóleikari
Söngkona 	 söngkona
Trommuleikari 	 trommuleikari
Bassaleikari 	 bassaleikari
Viðfangsefni 	 Viðfangsefnum
vistfræðinnar 	 vistfræðanna
Polystyrene 	 polystyrene
Polyethylene 	 polyethylene
matvæla-og 	 matvæla-
Hússtjórnarskóli 	 Hússtjórnarskólinn
Hússtjórnarskóli 	 hússtjórnarskóli
Húsmæðraskóli 	 Húsmæðraskólinn
hússtjórnarskóli 	 Hússtjórnarskólinn
Metanól 	 etanól
etanól 	 Metanól
Töframaðurinn 	 töframaðurinn
Krassusar 	 Crassusar
Rubiks 	 Rubik
Rubik 	 Rubiks
fljótandi 	 fljótandi-
Balears 	 Baleares
Baleares 	 Balears
áfangar 	 Áfangar
Heimsmeistaramótið 	 Heimsmeistaramót
Eingöngu 	 eingöngu
eingöngu 	 Eingöngu
Eingöngu 	 eingöngu
eingöngu 	 Eingöngu
stjórnmálananninum 	 stjórnmálamanninum
Gagnfræðaskóli 	 gagnfræðaskóli
gagnfræðaskóli 	 Gagnfræðaskóli
gagnfræðaskóli 	 Gagnfræðaskóli
Gagnfræðaskóli 	 gagnfræðaskóli
sçavans 	 savants
savants 	 sçavans
laughing 	 Laughing
sterkstu 	 sterkustu
fræðiheiði 	 fræðiheiti
friðargæslusveitir 	 friðargæslusveita
endasvæði 	 endasvæðinu
kynþroksa 	 kynþroska
android 	 Android
Kyrrahafsvæðinu 	 Kyrrahafssvæðinu
Believe 	 believe
Activating 	 activating
Consequence 	 consequence
indie-popparanna 	 indípopparanna
febrúarbylgina 	 febrúarbyltingina
Chichos 	 chichos
Hippoglossus 	 hippoglossus
hippoglossus 	 Hippoglossus
skammstöfnun 	 skammstöfun
Studio 	 Studios
Studios 	 Studio
Baróninn 	 baróninn
umbúðategund 	 umbúðartegund
Þjóðernishyggja 	 þjóðernishyggju
Umayyad-kalífönum 	 Umayyad-kalífunum
sírskotun 	 skírskotun
Hispaníóla 	 Hispaníólu
Hrekkjavöku 	 hrekkjavöku
Íslensku 	 íslensku
Stinky 	 sStinky
tryggingarsvikum 	 tryggingasvikum
ransóknarmann 	 rannsóknarmann
afdrigðin 	 afbrigðin
eigingleg 	 eigigleg
Apollons 	 Appolons
Appolons 	 Apollons
Viðarlundin 	 Viðarlundurinn
Viðarlundurinn 	 Viðarlundin
Hútum 	 Hútúum
útsendingsfyrirtæki 	 útsendingarfyrirtæki
Dred 	 Dreds
Sandford 	 Sanford
Dreds 	 Dred
Dreds 	 Dred
Sanford 	 Sandford
Falklandssundinu 	 Falklandseyjasundinu
vega 	 vega-
suðvesturin 	 suðvestur
vega 	 vega-
suðvesturin 	 suðvestur
mentir 	 menntir
tréið 	 tréð
Malaríu 	 malaríu
Jean 	 Jeane
stærðfræðinnar 	 stræðfræðinnar
aðdáendi 	 aðdáandi
Durkheims 	 Durkheim
tónlistinn 	 tónlistin
Þungarokk 	 þungarokk
Drúsusar 	 Drususar
Framsun 	 Framsund
Abrahamísku 	 abrahamísku
Eskimóa 	 Eskimóar
Blæaspar 	 blæaspar
Silfuraspar 	 silfuraspar
lasagna 	 lasana
lasana 	 lasagna
koltvísíringi 	 koltvísýringi
Landpítalans 	 Landspítalans
shintotrúar 	 sjintotrúar
Búddhalíkneski 	 Búddalíkneski
Skeljaröðun 	 skeljaröðun
Innsetningarröðun 	 innsetningarröðun
upphringitengingum 	 upphringitengingar
maltað 	 ómaltað
ómaltað 	 maltað
ómaltað 	 ómaltaður
maltaður 	 ómaltaður
ómaltaður 	 ómaltað
ómaltaður 	 maltaður
laggði 	 lagði
skeppnur 	 skepnur
Tónlistin 	 Tónlist
nálaeinir 	 Nálaeinir
gul-hvítur 	 gulhvítur
Slík 	 Slíka
ríkisneyðslu 	 ríkisneyslu
pólitiskum 	 pólitískum
verðlægi 	 verðlagi
Neóptólemos 	 Neoptólemos
Astyanax 	 Astýanax
Arabíska 	 arabíska
arabíska 	 Arabíska
norðurpólinn 	 Norðurpólinn
suðurpólinn 	 Suðurpólinn
gerr 	 gerir
þem 	 þeim
rifbenin 	 rifbeinin
gerr 	 gerir
þem 	 þeim
rifbenin 	 rifbeinin
Patróklus 	 Patróklos
Patróklus 	 Patróklos
Patróklus 	 Patróklos
Patróklus 	 Patróklos
Forritunarmálið 	 forritunarmál
forritunarmál 	 Forritunarmálið
prgrammable 	 programmable
Leonídas 	 Leonídasar
Samfélag 	 samfélag
Marianista 	 Maríanista
röksemdafærslur 	 röksemdafærslu
röksemdafærslu 	 röksemdafærslur
röksemdafærslur 	 röksemdafærslu
röksemdafærslu 	 röksemdafærslur
styðtu 	 styðstu
Setningin 	 setningin
Hlaðan 	 ‚Hlaðan
stór 	 stór‘
setningin 	 Setningin
setningin 	 Setningin
Setningin 	 setningin
Hlaðan 	 ‚Hlaðan
stór 	 stór‘
Gelíska 	 gelíska
Gelíska 	 gelíska
Sambandssinnna 	 sambandssinna
Bereinska 	 Bareinska
N-Þingeyjarsýslu 	 Norður-Þingeyjarsýslu
sömu 	 sömur
sömur 	 sömu
hljómsveitir 	 indíhljómsveitir
Pollapönk 	 Pollapönki
stéttarskipting 	 stéttskipting
danmörku 	 Danmörku
almeningur 	 almenningur
Laugaskarð 	 Laugaskörð
Þermopýle 	 Þermopýlæ
nútímasagnfræðingurinn 	 nútímasagnfræðingar
bækur 	 bækr
norður 	 norður-
liðinnu 	 liðinu
Goðakyn 	 Goðakyni
adygesku 	 adygeysku
Bernarsáttmáli 	 Bernarsáttmálinn
Bernarsáttmálinn 	 Bernarsáttmáli
höfundarétt 	 höfundaréttar
stúlkuni 	 stúlkunni
húsaleiguni 	 húsaleigunni
hegðunnar 	 hegðunar
Hamlets 	 Hamlet
Hamlet 	 Hamlets
Hnúðlaxar 	 hnúðlaxar
Hnúðlaxar 	 hnúðlaxar
hryggna 	 hrygna
hryggna 	 hrygna
hryggna 	 hrygna
hryggna 	 hrygna
dögginn 	 döggin
alsbert 	 allsbert
meðlimir 	 Meðlimir
Knattspyrnusambandsins 	 Knattspyrnusambands
nivk 	 nivkí
nivkí 	 nivk
hollensku 	 Hollensku
Krarólínu 	 Karólínu
Krarólínu 	 Karólínu
Latneskt 	 latneskt
latínsegl 	 Latínsegl
latínsegl 	 latínarsegl
nemendur 	 Nemendur
almenningsamgöngum 	 almenningssamgöngutækjum
ísllinsa 	 íslinsa
samgöngusamninga 	 samgöngusamning
Ob-La-Di 	 Ob-La-Da
Ob-La-Da 	 Ob-La-Di
vindáttog 	 vindátt
Forseti 	 forseti
Rússneska 	 rússneska
Rússneska 	 rússneska
Rússneska 	 rússneska
Sambandsríkisins 	 sambandsríkisins
Forseti 	 forseti
Forseti 	 forseti
Rússneska 	 rússneska
Rússneska 	 rússneska
Rússneska 	 rússneska
Sambandsríkisins 	 sambandsríkisins
Forseti 	 forseti
Klepragígur 	 Klepragígar
hraunkleprarnis 	 hraunkleprarnir
gosopiniu 	 gosopinu
slittróttar 	 slitróttar
Heimdallr 	 Heimdallur
Heimdallr 	 Heimdallur
Heimdallr 	 Heimdallur
Heimdallr 	 Heimdallur
Hrefnur 	 hrefnur
Hrefnur 	 hrefnur
hrefnur 	 Hrefnur
Mið-NorðurAtlandshafsstofni 	 Mið-Norður-Atlantshafsstofni
hrefnur 	 Hrefnur
hann 	 hanns
hanns 	 hann
presley 	 Presley
GeorgiaForeldrar 	 GeorgíuForeldrar
Neytendaaktívismi 	 neytendaaktívismi
Ronald 	 Ronaldo
Ronaldo 	 Ronald
Samleitnar 	 samleitnar
samleitnar 	 Samleitnar
Raunveruleg 	 raunverulega
raunverulega 	 Raunveruleg
Óræðar 	 ræðar
ræðar 	 Óræðar
leikjatölvuna 	 DS-leikjatölvuna
geislavirkni 	 Geislavirkni
þesu 	 þessu
tréin 	 trén
age 	 Rage
sumartíman 	 sumartímann
stofnfrumum 	 stofnfumum
stofnfumum 	 stofnfrumum
alkahólistar 	 alkóhólistar
Theater 	 Theatre
Theater 	 Theatre
Theatre 	 Theater
Theatre 	 Theater
Tajikistan 	 Tadsikistan
trjáhringjamynstrið 	 árhringjamynstrið
Risanna 	 risanna
Þriggja 	 þriggja
trjáhringjamynstrið 	 árhringjamynstrið
Risanna 	 risanna
Þriggja 	 þriggja
félagsskaps 	 félagsskapar
vinnadýr 	 vinnudýr
hagnaðarskini 	 hagnaðarskyni
áratug 	 áratugs
fiskveiðisjórnun 	 fiskveiðistjórnun
íslendingar 	 Íslendinga
Malmöí 	 Malmö
áratug 	 áratugs
himkynni 	 heimkynni
samtakann 	 samtakanna
Stanforðabryggjur 	 Stafnforðobryggjur
aðalega 	 aðallega
Y-litningi 	 X-litningi
X-litningi 	 Y-litningi
þurkuðum 	 þurrkuðum
maoríska 	 maoría
maoría 	 maoríska
óakveðna 	 óákveðna
Myanmar 	 Mjanmar
drottninginni 	 drottningunni
Cherso 	 Chersos
Chersos 	 Cherso
kónungsins 	 konungsins
bæjastæðunum 	 bæjarstæðunum
líkindafræðinar 	 líkindafræði
Bayesískri 	 bayesískri
líkindafræðinar 	 líkindafræði
Bayesískri 	 bayesískri
Gallinago 	 gallinago
gallinago 	 Gallinago
Stundaði 	 stundaði
uypplifa 	 upplifa
örvuna 	 örvun
violetta 	 Violetta
ljósfræðileg 	 ljósfræðilegt
veðurfræðileg 	 veðurfræðilegt
aðhyltist 	 aðhylltist
Skrökva 	 Skrökvu
Skrökvu 	 Skrökva
þjóðanna 	 Þjóðanna
fjallmennsku 	 fjallamennsku
Dufgusar 	 Dufgúsar
Dufgúsar 	 Dufgusar
Dugfúsar 	 Dufgúsar
Fjölgildur 	 fjölgildur
Fjölgildur 	 fjölgildur
Punjab-héraði 	 Punjabhéraði
‘Weaving 	 Weaving
Metaphor’ 	 Metaphor
World’ 	 World
Nýnorræna 	 Nýnorræn
páskadagur 	 Páskadagur
golf-strauminum 	 golfstrauminum
Tadsjikistan 	 Tadsikistan
Gresjufílsins 	 gresjufílsins
næringaríkri 	 næringarríkri
indie-poppararnir 	 indípoppararnir
segji 	 segi
Hjaltlandseyjum 	 Hjaltlandseyjar
Hjaltlandseyjar 	 Hjaltlandseyjum
kirkjunar 	 kirkjunnar
hljóðfœraleik 	 hljóðfæraleik
Jansenistum 	 Jansenista
suðurgata 	 Suðurgata
marglötungum 	 margflötungum
nefmæld 	 nefmælt
Söngkona 	 söngkona
handbókarleyfið 	 GNU-handbókarleyfið
frálst 	 frjálst
handbókarleyfið 	 GNU-handbókarleyfið
frálst 	 frjálst
villiafbrigðið 	 villiafbrigði
einandrunargildi 	 einangrunargildi
Bandarísk 	 bandarísk
Raspútíns 	 Raspútín
Samtvinnun 	 samtvinnun
intersectionality 	 intersectionalism
intersectionalism 	 intersectionality
samtvinnun 	 Samtvinnun
kollakoppur 	 skollakoppur
Fornfræðafélaginu 	 Fornfræðafélagsins
Hitler 	 Hitlers
Hitler 	 Hitlers
Byringu 	 Byrginu
karamelskel 	 karamelluskel
sérþekkingarfyrirtæki 	 þekkingarfyrirtæki
sérþekkingarfyrirtæki 	 þekkingarfyrirtæki
watereri 	 ×watereri
‘Vossi 	 ‘Vossii
Guðs 	 Guð
Guð 	 Guðs
áhyggjur 	 Áhyggjur
Sólmiðjukenning 	 sólmiðjukenningin
Galíleó 	 Galílei
Galílei 	 Galíleó
sólmiðjukenningin 	 Sólmiðjukenning
ρχων 	 αρχων
Basilíka 	 basilíka
Skurðgoðið 	 skurðgoðið
Okhotsk 	 Okotsk
Smilodon 	 smilodon
Skrautyrði 	 skrautyrði
Tunglið 	 tunglið
Vektors 	 Vektor
tunglið 	 Tunglið
spingur 	 springur
Vektor 	 Vektors
Postullegu 	 postullegu
Postullegu 	 postullegu
Postullegu 	 Postullegir
Catilínu 	 Catilinu
lantaníð 	 lantaníði
Norðulöndin 	 Norðurlöndin
corporate 	 Corporate
executives 	 Executives
politicians 	 Politicians
industry 	 Industry
Álfgeirsvöllu 	 Álfgeirsvöllum
Álfgeirsvöllum 	 Álfgeirsvöllu
Ófrumbjarga 	 frumbjarga
Ófrumbjarga 	 frumbjarga
frumbjarga 	 Ófrumbjarga
Inn 	 Inni
omfl 	 ofl
bakteríur 	 Bakteríur
veðurfræða 	 veðurfræði
siglingafræða 	 siglingafræði
gæludýrafiskarnir 	 gælufiskarnir
Sardinops 	 sardinops
Anatóliu 	 Anatólíu
rómverjar 	 Rómverjar
rómverjar 	 Rómverjar
rómverjar 	 Rómverjar
rómverjar 	 Rómverjar
Blandað 	 blandað
hagkerfi 	 Hagkerfi
blá-græna 	 blágræna
nátturulegan 	 náttúrlegan
hemisellulósa 	 hemísellulósa
evrópubúa 	 Evrópubúa
papýrus 	 Papýrus
Papýrus 	 papýrus
repúblíkanaflokksins 	 Repúblikanaflokksins
Barack 	 Baracks
fornfræðafélagi 	 Fornfræðafélagi
Cumberland- 	 Cumberland
fornleifafélaginu 	 Fornleifafélaginu
þallarætt 	 Þallarætt
Ísrannsóknarskipið 	 ísrannsóknarskipið
Feðradeginum 	 feðradeginum
Feðradeginum 	 feðradeginum
útgáfufyrritæki 	 útgáfufyrirtæki
hljósmveitarinnar 	 hljómsveitarinnar
Trúbrot 	 Trúbrots
skáldskap 	 spáskáldskap
Bandaríkjana 	 Bandaríkjanna
military-industrial 	 military–industrial
Gyðingum 	 gyðingum
hemoglóbínum 	 hemóglóbínum
bæum 	 bæjum
kaflan 	 kaflann
kaflan 	 kaflann
Gyðing 	 Gyðinga
einning 	 einnig
Gyðinga 	 gyðinga
rauðhumla 	 Rauðhumla
Rokkabillí 	 rokkabillís
Grase 	 Grease
Setningin 	 ‚Setningin
Setningin 	 ‚Setningin
Hlaðan 	 ‚Hlaðan
Hlaðan 	 ‚Hlaðan
stór 	 stór‘
stór 	 stór‘
sönn 	 sönn‘
Setningin 	 ‚Setningin
Setningin 	 ‚Setningin
Hlaðan 	 ‚Hlaðan
Hlaðan 	 ‚Hlaðan
stór 	 stór‘
stór 	 stór‘
sönn 	 sönn‘
sönn 	 sönn‘
sögulega 	 Sögulega
L´Axe 	 LAxe
kristur 	 Kristur
aððallega 	 aðallega
Öldungardeildarinnar 	 öldungardeildarinnar
Demókratar 	 demókratar
Repúblikanar 	 repúblikanar
vísindum 	 Vísindum
Einhyrningurinn 	 einhyrningurinn
Co-operation 	 Cooperation
samræmismat 	 samræmismati
Færeyska 	 færeyska
Færeyska 	 færeyska
strjónað 	 stjórnað
Færeyska 	 færeyska
Færeyska 	 færeyska
Færeyska 	 færeyska
strjónað 	 stjórnað
Færeyska 	 færeyska
Hefðbundin 	 hefðbundin
反体字，pingyin 	 繁体字，pinyin
hefðbundin 	 Hefðbundin
pingyin 	 pinyin
Trojuborgar 	 Trójuborgar
Trojumenn 	 Trójumenn
Trojuhestinum 	 Trójuhestinum
Agamemnosar 	 Agamemnons
Jesúítaprestar 	 jesúítaprestar
heppnaðis 	 heppnaðist
appelsíusafa 	 appelsínusafa
Columbiu 	 Columbia
Engjasvín 	 engjasvín
Istanbúls 	 Istanbúl
Krossfiskur 	 Krossfiskar
ssæstjörnur 	 sæstjörnur
ssæstjörnur 	 sæstjörnur
Handayfirlangningar 	 handayfirlagningar
herstöðvarandstæðinga 	 herstöðvaandstæðinga
Californiuflóa 	 Kaliforníuflóa
sterkindahraðallinn 	 sterkeindahraðallinn
öreindahraðall 	 eindahraðall
Galilei 	 Galileo
pastúnska 	 pastúnsk
pastúnsk 	 pastúnska
fjöldamótmæli 	 fjöldamótmælum
Víkinga-þungarokk 	 Víkingaþungarokk
lúsitaníumönnum 	 Lúsitaníumönnum
rómverja 	 Rómverja
íberíuskaganum 	 Íberíuskaganum
effecta 	 effekta
hernaðaleiðangur 	 hernaðaleiðangri
Stóra-Núpi 	 Stóra-Núpii
herstöðum 	 herstöðvum
hnúðsvanir 	 Hnúðsvanir
understöðusteinum 	 undirstöðusteinum
selenium 	 seleniums
molybdenum 	 molybdenums
Marshall 	 Marshalls
Ritgerðin 	 Ritgerðina
Ritgerðina 	 Ritgerðin
Vestur-Falklandseyju 	 Vestur-Falklandseyjar
hugIjúfu 	 hugljúfu
alþjóðleg 	 Alþjóðleg
innflitjenda 	 innflytjenda
repúblikanaflokknum 	 Repúblikanaflokknum
Tsjad 	 Tjad
Kassamerki 	 kassamerki
myllumerki 	 Myllumerki
verduð 	 vernduð
Tequila 	 tequila
tequilana 	 tequila
Náttúruhyggja 	 náttúruhyggja
svartmálminn 	 svartmálm
Fjölbrautaskóli 	 fjölbrautaskóli
Vesurlands 	 Vesturlands
fjölbrautaskóli 	 Fjölbrautaskóli
Fjölbrautaskólans 	 Fjölbrautaskóli
eggfóstursfæðing 	 gulfóstursfæðing
gulfóstursfæðing 	 eggfóstursfæðing
Fjölbrautaskóli 	 fjölbrautaskóli
Vesurlands 	 Vesturlands
fjölbrautaskóli 	 Fjölbrautaskóli
Fjölbrautaskólans 	 Fjölbrautaskóli
eggfóstursfæðing 	 gulfóstursfæðing
gulfóstursfæðing 	 eggfóstursfæðing
þettist 	 þéttist
aðalega 	 aðallega
Nasista 	 nasista
miðsuður 	 miðsuður-
þurftiru 	 þurfti
Riddarinn 	 riddarinn
fullorðina 	 fullorðinna
Dunaj 	 Duna
Duna 	 Dunaj
Duna 	 Dunav
Dunav 	 Duna
Geislavanir 	 Geislavarnir
tiltörulega 	 tiltölulega
veegar 	 vegar
Blástakkur 	 Blástakk
breytir 	 Breytir
árstímum 	 árstíðum
allhvít 	 alhvít
stélÍ 	 stél
demokrötum 	 demókrötum
Bengalska 	 bengalska
Bengalska 	 bengalska
Bengalska 	 bengalska
Bengalska 	 bengalska
likillin 	 lykillin
stjarnar 	 stjarna
stjarnar 	 stjarnan
fjármálafyrirtæki 	 Fjármálafyrirtæki
fjármálafyrirtækja 	 Fjármálafyrirtæki
áarinnar 	 árinnar
forn-grísku 	 forngrísku
republikanir 	 repúblikanir
demokratar 	 demókratar
Drottinn 	 drottinn
Léttfeta 	 Léttfeti
Léttfeta 	 Léttfeti
verðbólgu 	 verðbólgunar
Lúthersku 	 lúthersku
tvíburaróður 	 tvíburabróður
Nelson 	 Nelsons
Nelson 	 Nelsons
Moutsapha 	 Moustapha
eyðimörkum 	 eyðimerkum
Siri 	 Sri
Sekúndum 	 sekúndum
hvernig 	 hverning
hvernig 	 hverning
Sakishima-eyjar 	 Sakishima-eyjum
Skagamálararnir 	 Skagamálarar
listamannanýlenda 	 listamannanýlendu
akademísku 	 Akademísku
Argentínsk 	 argentínska
argentínska 	 Argentínsk
Londons 	 London
saltpétursýrunnar 	 saltpéturssýrunni
metorði 	 metorðið
metorðið 	 metorði
Svæðameðferð 	 svæðameðferð
svæðanudd 	 Svæðanudd
þeagar 	 þegar
þeagar 	 þegar
gítarleikara 	 jazzgítarleikara
pólitiskri 	 pólitískri
mettnar 	 metnar
norður 	 norður-
hafssvæðum 	 hafsvæðum
aðhláturefnið 	 aðhlátursefnið
Príamusar 	 Príamosar
Patróklus 	 Patróklos
víðfemt 	 víðfeðm
Fnjóskárdal 	 Fnjóskadal
Bárðadal 	 Bárðardal
umhveri 	 umhverfi
Aramíska 	 Arameíska
stafróinu 	 stafrófinu
Hvalfjarðarstrandarhreppur 	 Hvalfjarðarstrandarhreppi
Þéttbýlisstaðir 	 þéttbýlisstaðir
Hrekkjavökunni 	 hrekkjavökunni
Hrekkjavökupartýi 	 hrekkjavökupartýi
félagshagfræðilega 	 félagshagfræðilegu
málaðarlegt 	 mánaðarlegt
hámarkslengd 	 hámarksvegalengd
þeim 	 þem
Reglugerð 	 reglugerð
reglugerð 	 Reglugerð
mið 	 mið-
Klasin 	 Klasinn
framkvænd 	 framkvæmd
Rússneska 	 Rússnesk
Rússneska 	 rússneska
Rússneska 	 Rússnesk
Rússneska 	 rússneska
Rússneska 	 Rússnesk
Rússneska 	 rússneska
Samningur 	 samningur
samningur 	 Samningur
vopantækni 	 vopnatækni
inúítar 	 Inúítar
Flauels-djass 	 Flauelsdjass
offtast 	 oftast
offtast 	 oftast
offtast 	 oftast
offtast 	 oftast
Sovíetríkjanna 	 Sovétríkjanna
Benediktínusar 	 Bendediktínusar
Bendediktínusar 	 Benediktínusar
hæðstakaupstað 	 Hæstakaupstað
Evrópusamtökin 	 Evrópusamtök
Evrópusamtökin 	 Evrópusamtök
hugsanlega 	 Hugsanlega
systrafélaginu 	 systrafélagsins
kjarnaflofnun 	 kjarnaklofnun
óhreyna 	 óhreina
kröstugt 	 kröftugt
SEAL-sérsveitarmaður 	 SEAL-sérsveitarmaðurinn
skattheimtunnar 	 skattheimtunar
Franscisco 	 Francisco
Óendurnýjanlegar 	 óendurnýjanlegar
Nonrenewable 	 Non-renewable
óendurnýjanlegar 	 Óendurnýjanlegar
Abrahamísk 	 Abrahams
ættföðursins 	 ættföðurins
Abrahams 	 Abrahamísk
Borgarleg 	 Borgaraleg
Breskri 	 breskri
Hljóðhönnuður 	 Hljóðhönnuðurinn
klofunarhljóð 	 klofnunarhljóð
Þyrping 	 þyrping
Ilíonskviða 	 Ilíonskviðu
Ilíonskviðu 	 Ilíonskviða
Trotskí 	 Trotskíj
íslenski 	 Íslenski
veraldrahyggja 	 veraldrarhyggja
veraldrahyggja 	 veraldarhyggja
veraldarhyggja 	 veraldrarhyggja
hrein-blóðar 	 hrein-blóðs
fjölskylfum 	 fjölskyldum
sjónvarpsþættinum 	 sjónvarpsmþættinum
tungumálfræðingar 	 tungumálafræðingar
hlýur 	 hlýtur
strand- 	 strand-og
geislavirknisvopn 	 geislavirknivopn
Weeckin’ 	 Weeckin
Háskóla 	 háskóla
skutinum 	 skutnum
Hliðarhljóð 	 hliðarhljóð
hliðarhljóð 	 Hliðarhljóð
tungunni 	 tungun
tungun 	 tungunni
tengund 	 tegund
rómverja 	 Rómverja
einsx 	 eins
Bretlandseyjar 	 Bretlandseyja
Efnahagsbandalaginu 	 Efnahagsbandalagsins
tenglsin 	 tengslin
áþreyfanlega 	 áþreifanlega
mjólkursykursóþol 	 mjólkursykuróþol
mjólkursykur 	 mjólkursykuróþol
glossularia 	 grossularia
legst 	 leggst
Suður-Amerískri 	 suður-amerískri
O‘Reilly 	 OReilly
Alexandrínska 	 alexandríska
sósíademókrataflokkur 	 sósíademókrataflokkinn
Kransæðahjáveituaðgerðir 	 Kransæðahjáveituaðgerð
algengastu 	 algengasta
algengastu 	 algengasta
fernigsfylki 	 ferningsfylki
rógburðs 	 rógburð
Sprinters 	 Sprinter
Sprinters 	 Sprinter
ólömætum 	 ólögmætum
Bruuns 	 Bruun
orkuframleiðslu 	 vatnsorkuframleiðslu
heimstyrjöldinni 	 heimsstyrjöldinni
Keisarans 	 keisarans
lýgileg 	 lygileg
lýgileg 	 lygileg
Hólmverjar 	 Hólmverja
Hljómsveitir 	 hljómsveitir
Fönk-rokk 	 fönk-rokk
Afğānistān 	 Afġānistān
lotningafullt 	 lotningarfullt
Betlehemturninn 	 Betlehemsturninn
portúgal 	 Portúgal
hjómsveitini 	 hljómsveitina
kendur 	 kenndur
Islendingum 	 Íslendingum
Islendingum 	 Íslendingum
gæludýrinn 	 gæludýrin
nyrðsta 	 nyrsta
samskiptamunstur 	 samskiptamynstur
skrifuðu 	 skrifu
Pythons 	 Python
skrifuðu 	 skrifu
Python 	 Pythons
‘bun’ 	 ‘bu’
‘bu’ 	 ‘bun’
Poincaré 	 Poncaré
Poncaré 	 Poincaré
samleikona 	 samleikkona
Éireann 	 Eireann
Eireann 	 Éireann
Neyðsla 	 Neysla
Neyðsla 	 Neysla
blómasafi 	 blómasafa
blaðlýsog 	 blaðlýs
Cabrillo 	 Cabrilho
Cabrilho 	 Cabrillo
Formaður 	 formaður
menningamálastjóri 	 menningarmálastjóri
Útganga 	 útganga
útganga 	 Útganga
mindast 	 myndast
þikkari 	 þykkari
fyrirbiggja 	 fyrirbyggja
heildarhnappurinn 	 heildarhnappinn
dreyfingu 	 dreifingu
Ríkisins 	 ríkisins
Ríkisins 	 ríkisins
Ríkisins 	 ríkisins
Ríkisins 	 ríkisins
Landgræðslusjóði 	 Landgræðslusjóðs
Húsfriðun 	 Húsafriðun
stjórnmálastofnanir 	 stjórnmálastofnanirnar
ferskvatnsfiskarsem 	 ferskvatnsfiskar
deilitengund 	 deilitegundir
zeta-fallsins 	 zetafallsins
Philharmonikerer 	 Philharmoniker
Ríkisstjórn 	 ríkisstjórn
Ríkisstjórn 	 ríkisstjórn
þur 	 þurr
Austur-Karabískur 	 Austurkarabískur
örsmæðarreikningi 	 örsmæðareikningi
Leibnitz 	 Leibniz
klofningar- 	 klofnunar-
kjarnorkuvopn 	 kjarnaorkuvopn
kjarnaorkuvopn 	 kjarnorkuvopn
Ungverjalans 	 Ungverjalands
hanns 	 hans
Felidae 	 felidae
Nimravinae 	 nimravinae
Macharodontinae 	 macharodontinae
Erítreu 	 Eritreu
Tsjad 	 Tjad
vegalengt 	 vegalengd
Westminsterhöllu 	 Westminsterhöll
Buckinghamhöllu 	 Buckinghamhöll
Eiginkonur 	 eiginkonur
Blettakarfinn 	 blettakarfinn
forleifafræðinga 	 fornleifafræðinga
aðildaríki 	 aðildarríki
Lýðræðislega 	 Lýðræðislegri
Lóuþræla 	 Lóuþrælar
Eldfjöll 	 eldfjöll
eldfjöll 	 Eldfjöll
Jörðinni 	 jörðinni
eldfjöll 	 Eldfjöll
Franska 	 franska
Sjávarfitjar 	 sjávarfitjar
sjávarfitjar 	 Sjávarfitjar
stólsing 	 stólsins
Myndbreytingar 	 Myndbreytingarnar
grunge-hreyfingunni 	 grugghreyfingunni
geimstöðvar 	 Geimstöðvar
mannlíkamanum 	 mannlíkamann
Hogwartsskólinn 	 Hogwartskólinn
helögum 	 heilögum
helögum 	 heilögum
helögum 	 heilögum
Kýrilískt 	 Kýrillískt
hvítarússnesku 	 hvítrússnesku
sovétríkjunum 	 Sovétríkjunum
Montferrat 	 Monferrato
Monferrato 	 Montferrat
Capricornus 	 capricornus
Þjóðfræði 	 þjóðfræði
helíumgassins 	 helíumgass
Litli-Árskógsandur 	 Litli-Árskógssandur
gistis 	 gisti
gistis 	 gisti
gisti 	 gistis
gisti 	 gistis
lggja 	 liggja
Formúla 	 formúla
formúla 	 Formúla
lggja 	 liggja
Formúla 	 formúla
formúla 	 Formúla
sálaraflskennignar 	 sálaraflskenningar
Strategy 	 strategy
lífsins 	 lífssins
Kaspía-haf 	 Kaspíahaf
Ted 	 Teds
Teds 	 Ted
Rannsóknir 	 rannsóknir
Rannsóknir 	 rannsóknir
rannsóknir 	 Rannsóknir
rannsóknir 	 Rannsóknir
hlóðstafrófinu 	 hljóðstafrófinu
líklegast 	 Líklegast
Sommerville 	 Somerville
Sommerville 	 Somerville
fjölbreutum 	 fjölbreyttum
árstíðarskipt 	 árstíðaskipt
rússneska 	 Rússneska
vörðurinn 	 Vörðurinn
Bur 	 Buer
kumt 	 kummt
Vörðurinn 	 vörðurinn
skólanum 	 Háskólanum
Háskólanum 	 skólanum
aðalega 	 aðallega
Dirichlet 	 Dirichlets
pidgeonhole 	 pigeonhole
principle 	 Principle
Stúart-ættinni 	 Stúartættinni
þýskalandi 	 Þýskalandi
Íslensku 	 íslensku
Samveldi 	 samveldi
Kjarnorkver 	 Kjarnorkuver
Kjarnorkver 	 kjarnorkuver
kjarnorkuver 	 Kjarnorkuver
nútímalyfjafræði 	 Nútímalyfjafræði
Geislasópur 	 Geislasópurinn
vexx 	 vex
sedursviður 	 sedrusviður
óráðanlegur 	 óráðanlegar
þjóðískr 	 þjóðiskr
rómarveldi 	 Rómarveldi
Nimravinae 	 nimravinae
Prolailurinae 	 prolailurinae
Felinae 	 felinae
tilheyraog 	 tilheyra
Machairodontinae 	 machairodontinae
verkefni 	 verkefið
Bermuda 	 Bermúda
Bermuda 	 Bermúda
Bermuda 	 Bermúda
Bermuda 	 Bermúda
íslendingasögum 	 Íslendingasögum
deyji 	 deyi
Ambient 	 ambient
hrygningafiskur 	 hrygningarfiskur
sjálfsvígstirlaunir 	 sjálfsvígstilraunir
Westminsterhöllin 	 Westminsterhöll
iðnaðin 	 iðnaðinn
öfuggi 	 öfuguggi
Hollensku 	 Hollenska
Hollensku 	 Hollenska
Hollenska 	 Hollensku
Hollenska 	 Hollensku
Hollenska 	 Hollensku
Hsien-fanf 	 Hsien-fan
Art 	 Arts
Arts 	 Art
mgcosθ 	 m·g·cosθ
mgsinθ 	 m·g·sinθ
flauels-djass 	 flauelsdjass
corderoíti 	 korderoíti
hæðsta 	 hæsta
Búlagaríumanna 	 Búlgaríumanna
fjöldabreytingarEru 	 fjöldabreytingar
þjóðverjar 	 Þjóðverjar
Yfirvöldin 	 Yfirvöld
sérstak 	 sérstaka
Oxford-heimspeki 	 Oxford-heimspekin
Bretlandseyja 	 Bretlandseyjum
hryggleysinga 	 hryggleysingja
DJ‘s 	 DJs
Spetuaginta 	 Septuaginta
Ástralíua 	 Ástralíu
upfinningu 	 uppfinningu
upfinningu 	 uppfinningu
Hússtjórnarskóli 	 Hússtjórnarskóla
Nordiskt 	 Nordisk
Nordisk 	 Nordiskt
Spænskgræna 	 Spanskgræna
Wallonie 	 Wallonien
Wallonie 	 Wallonië
Wallonien 	 Wallonie
Wallonië 	 Wallonie
lítríkum 	 litríkum
liggji 	 liggi
Bandaríkjaher 	 bandaríkjaher
liggji 	 liggi
Bandaríkjaher 	 bandaríkjaher
Rastafari 	 rastafari
Kristindómi 	 kristindómi
Gyðingdómi 	 gyðingdómi
ótrúðverðugar 	 ótrúverðug
gamanvisur 	 gamanvísur
Bjbörnsson 	 Björnsson
Lanarkshire 	 Lanrikshire
Lanrikshire 	 Lanarkshire
Lanrikshire 	 Lanarkshire
Lanarkshire 	 Lanrikshire
Sósjalíski 	 Sósíalíski
Vinstriflokkurinn 	 vinstriflokkurinn
jónasson 	 Jónasson
Forsetinn 	 forsetinn
National 	 national
National 	 national
national 	 National
national 	 National
fornleyfagröft 	 fornleifagröft
Skiþíúmanna 	 Skiþíumanna
Keldusvín 	 keldusvín
keldusvín 	 Keldusvín
Hilditönn 	 hilditönn
minstu 	 minnstu
iðullega 	 iðulega
víkinga-þungarokk 	 víkingaþungarokk
Amelíuborg 	 Amalíuborg
stóumaðurinn 	 Stóumaðurinn
Claudiusar 	 Claudius
Claudiusar 	 Claudíusar
Eiturvirkni 	 eiturvirknin
eiturvirknin 	 Eiturvirkni
einangrunnar 	 einangrunar
málýskur 	 mállýskur
Frumsemdur 	 Frumsendur
Frumsemdur 	 Frumsendur
Kolmogorovs 	 Kolmogorov
Kolmogorov 	 Kolmogorovs
frumsemdur 	 frumsendur
frumsemdur 	 frumsendur
Frumsemdur 	 Frumsendur
Frumsemdur 	 Frumsendur
Kolmogorovs 	 Kolmogorov
Kolmogorov 	 Kolmogorovs
frumsemdur 	 frumsendur
frumsemdur 	 frumsendur
anjsósuna 	 ansjósuna
félagskapur 	 félagsskapur
kosningakerfum 	 kosningakerfi
kosningakerfum 	 kosningakerfi
ameríku 	 Ameríku
Systurborgir 	 Systraborgir
philosophikal 	 philosophical
Drykkju 	 drykkju
Claudiusi 	 Claudíusi
Neró 	 Nerós
Nerós 	 Neró
sterki- 	 sterki
kalsidon 	 kalsedon
afskektasti 	 afskekktasti
einmannalegasta 	 einmanalegasta
bandarískur 	 Bandarísku
Bandarísku 	 bandarískur
Dyflinnissvæðið 	 Dyflinnarsvæðið
upprunalega 	 Upprunalega
skívunni 	 skífunni
upprunalega 	 Upprunalega
skívunni 	 skífunni
evrópuráðið 	 Evrópuráðið
Krítartímabilinu 	 krítartímabilinu
Logique 	 logique
logique 	 Logique
Rökfræðin 	 rökfræðin
norður-England 	 Norður-Englandi
Trimophe 	 Triomphe
l´Étoile 	 lÉtoile
Han 	 Hans
Amerískum 	 Amerískur
Bangladesh 	 Bangladess
Kvöldúlfs 	 Kveldúlfs
Kvöldúlfs 	 Kveldúlfs
alkohól 	 alkóhól
einning 	 einnig
Guðs 	 Guð
Guðs 	 Guð
Guð 	 Guðs
Guð 	 Guðs
Sinfóníuhljómsviet 	 Sinfóníuhljómsveit
sinfóníuhljómsveitar 	 Sinfóníuhljómsveit
Manitoba 	 Manitóba
Festosdiskurinn 	 Fæstosdiskurinn
Festoskringlan 	 Fæstoskringlan
Festosdiskurinn 	 Fæstosdiskurinn
Festoskringlan 	 Fæstoskringlan
núorðið 	 Núorðið
Miklartorg 	 Miklatorg
Gömlu-Hringbrautar 	 Gömlu-Hringbraut
krabbans 	 krabbanns
Rússneska 	 rússneska
rússneska 	 Rússneska
Kennitöluhopp 	 kennitöluhopp
almennt 	 Almennt
Gram-jákvæð 	 gram-jákvæð
Gramlitun 	 gramlitun
Alska 	 Alaska
ReykdæluÍ 	 Reykdælu
siðfræðinar 	 siðfræðinnar
raunveruleikan 	 raunveruleikanum
raunveruleikanum 	 raunveruleikan
Íslenkar 	 Íslenskar
kúlutyggjóböndin 	 kúlutyggjóbönd
endurspeglast 	 endurspegast
tiheyrðu 	 tilheyrðu
alríkishéraðsins 	 alríkishéraðið
alríkishéraðsins 	 alríkishéraði
alríkishéraði 	 alríkishéraðið
and 	 Land
Land 	 and
brtti 	 bretti
brtti 	 bretti
Biskupsdæmi 	 Biskupsdæmið
Biskupsdæmi 	 biskupsdæmi
Biskupsdæmi 	 Biskupsdæmið
Biskupsdæmi 	 biskupsdæmi
biskupsdæmi 	 Biskupsdæmið
biskupsdæmi 	 Biskupsdæmi
hlóðfæri 	 hljóðfæri
Acoustic 	 acoustic
VeifaHöndum 	 VeifaHöldum
VeifaHöldum 	 VeifaHöndum
klasin 	 klasinn
Landgræðsla 	 Landgræðslan
framn 	 fram
Saka 	 Sakha
Saka 	 Sakha
Респу́блика 	 Республиката
Саха́ 	 Саха
Respublika 	 Respublikata
Sakha 	 Saka
Саха 	 Саха́
Республиката 	 Респу́блика
Sakha 	 Saka
Respublikata 	 Respublika
sjálfstjórnarlýðveldi 	 Sjálfstjórnarlýðveldi
fyljar 	 fylgjar
Demókrata 	 demókrata
Jörðinni 	 jörðinni
Wikipedía 	 Wikipedia
Wikipedía 	 Wikipedia
Kaldhæðnislega 	 kaldhæðnislegt
textan 	 textann
Agrippina 	 Agrippa
Agrippa 	 Agrippina
framleiðar 	 framleiðir
Reynistaðarbræðra 	 Reynistaðabræðra
hindanir 	 hindranir
Rekstrahagfræðin 	 Rekstrarhagfræðin
saxafónn 	 saxófónn
einsleitnar 	 einsleitar
Tónlistar 	 Tónlistar-og
Ottomanveldið 	 Ottómanaveldið
Hippias 	 Hippías
Hippias 	 Hippías
Hippias 	 Hippías
Hippias 	 Hippías
erTidbinbilla 	 Tidbinbilla
Áströlsk 	 áströlsk
Beinagrind 	 beinagrind
beinagrind 	 Beinagrind
enHalloweentown 	 Halloweentown
sverðfiskategund 	 sverðfiskstegund
úrskurðaur 	 úrskurðaður
Nytjagreiðslureglan 	 nytjagreiðslureglan
sykursyki 	 sykursýki
súrefnissnauður 	 súrefnissnauðum
Trúbador 	 trúbador
serbo-króatískar 	 serbókróatískar
»hapta 	 hapta
snytrir« 	 snytrir
skólafélugunum 	 skólafélögunum
Book 	 Books
Book 	 Books
Books 	 Book
Books 	 Book
barkakýlið 	 Barkakýlið
Adamsepli 	 adamsepli
öskudreifjar 	 öskudreif
fjöldan 	 fjöldann
öskudreifjar 	 öskudreif
fjöldan 	 fjöldann
Rómverska 	 rómverska
nánst 	 nánast
kennisettningum 	 kennisetningum
Múmínsnáðin 	 Múmínsnáðinn
Múmínfjölskildunni 	 Múmínfjölskyldunni
ĥjurt 	 jurt
Franska 	 franska
franska 	 Franska
Franska 	 franska
franska 	 Franska
Aleng 	 Algeng
dufari 	 daufari
Talaðinn 	 Talaði
Clayfac 	 Clayface
heilbrigðisstofnunin 	 Alþjóðaheilbrigðisstofnunin
Organisation 	 Organization
effectum 	 effektum
Hellsing 	 Hellsings
Hellsings 	 Hellsing
Hollenska 	 hollenska
hollenska 	 Hollenska
Lýðveldi 	 lýðveldi
lýðveldi 	 Lýðveldi
kippur-stríðið 	 kippúr-stríðið
ramadan-stríðið 	 ramadanstríðið
október-stríðið 	 októberstríðið
brókeraður 	 Brókeraður
Laugardalshöll 	 Laugardalsvöll
Laugardalsvöll 	 Laugardalshöll
Víkingarnir 	 víkingarnir
Adventures 	 Aventures
myndasöguhöfundinn- 	 myndasöguhöfundinn
Fennoskandia 	 Fennoskandiya
Fennoskandia 	 Fennoskandiya
Fennoskandia 	 Fennoskandiya
Fennoskandiya 	 Fennoskandia
Fennoskandiya 	 Fennoskandia
Fennoskandia 	 Fennoskandiya
Fennoskandia 	 Fennoskandiya
Fennoskandia 	 Fennoskandiya
Fennoskandiya 	 Fennoskandia
Fennoskandiya 	 Fennoskandia
Integral 	 Integra
glóarþræði 	 glóðarþræði
Örfirisey 	 Örfærisey
Örfirisey 	 örfirisey
Örfirsey 	 Örfursey
Örfærisey 	 Örfirisey
Öffursey 	 Örfursey
Örfursey 	 Örfirsey
Örfursey 	 Öffursey
Japönsku 	 japönsku
andspyrnuhreifingin 	 andspyrnuhreyfingin
gljándi 	 gljáandi
Spænsku 	 spænsku
Borgarastyrjöldinni 	 borgarastyrjöldinni
Fjölvinýlklóríð 	 Fjölvínýlklóríð
Fjölvinýlklóríð 	 Fjölvínýlklóríð
fullkomnlega 	 fullkomlega
skilníng 	 skilning
mannfjelaginu 	 mannfélaginu
»meiri 	 meiri
Heimdallar« 	 Heimdallar
ritsjóra 	 ritstjóra
Bahamaseyjar 	 Bahamaeyjar
Bahamaseyjar 	 Bahamaeyjar
høgskole 	 høyskole
højskole 	 høyskole
højskole 	 høgskole
Grotius 	 Grotiusi
Antonin 	 Antonín
flestar 	 Flestar
Mýrarsýslu 	 Mýrasýslu
Hafrannsóknarstofnun 	 Hafrannsóknastofnun
Martinleikaravals-leikstjóra 	 leikaravalsleikstjóra
Andrésfjöllum 	 Andesfjöllum
konungsríkin 	 konungaríkin
marktækt 	 marktekt
málamiðlannavandamálinu 	 málamiðlanavandamálinu
Apenninefjöllum 	 Apennínafjöllum
Apenninefjöllum 	 Apennínafjöllum
húðkrabbameins 	 krabbameins
krabbameins 	 húðkrabbameins
Throught 	 Through
Svipunnar 	 svipunnar
meirihluta-flokkunm 	 meirihlutaflokkunum
kínverska 	 Kínverska
fjárhagsbókhaldi 	 Fjárhagsbókhald
Fordómur 	 Fordómar
Fordómur 	 Fordómar
Afghanistan 	 Afganistan
and 	 land
land 	 and
Ítarleg 	 ítarleg
seljanda¹ 	 seljanda
Kvótakerfið 	 kvótakerfið
Kvótakerfið 	 kvótakerfið
Borgarastríðinu 	 borgarastríðinu
endurnýtanleg 	 endurnýjanlegri
furutugund 	 furutegund
Mullah 	 Mulla
Mulla 	 Mullah
’afandī 	 afandī
stuningsmeðferð 	 stuðningsmeðferð
Vatnsleysanlegar 	 óvatnsleysanlegar
óvatnsleysanlegar 	 Vatnsleysanlegar
beyttur 	 beittur
drullugan 	 drullugann
botnin 	 botninn
botnin 	 botninn
Vélhjól 	 vélhjól
mennig 	 menning
hamlaust 	 hamslaust
Children´´ 	 Children
fjallent 	 fjalllent
mið-Ítalíu 	 Mið-Ítalíu
satyrixon 	 satyrikon
Rótaskrossi 	 Rotaskrossi
Heljardalsheiði 	 thHeljardalsheiði
Thomas 	 Thomasar
Jefferson 	 Jeffersons
government 	 Government
Baringshafi 	 Beringshafi
Hallormsstaðaskóg 	 Hallormsstaðaskógi
Lesefni 	 lesefni
Lesefni 	 lesefni
Philadelphia 	 Philadelphiu
vélmenni 	 Vélmenni
fyritækja 	 fyrirtækja
fyrirækis 	 fyrirtækis
fyritækja 	 fyrirtækja
fyrirækis 	 fyrirtækis
grænlenska 	 Grænlenska
kalaallit 	 kalaallisut
kalaallisut 	 kalaallit
eskimó-aleúsku 	 eskimó-aleútísku
náskilt 	 náskylt
Spinachia 	 spinachia
Spinachia 	 spinachia
Norður-Ameríska 	 norður-ameríska
Apeltes 	 apeltes
Vestmanneyjum 	 Vestmannaeyjum
rafhlaðann 	 rafhlaðan
rafhlaðan 	 rafhlaðann
Kostnaður 	 kostnaður
kostnaður 	 Kostnaður
breitileika 	 breytileika
fleirri 	 fleiri
almannafjárs 	 almannafjár
afþreyingi 	 afþreying
alþjólegum 	 alþjóðlegum
ríkisatkvæðagreiðslu 	 fylkisatkvæðagreiðslu
ríkisatkvæðagreiðslu 	 fylkisatkvæðagreiðslu
millim 	 milli
Náttúrlegt 	 Náttúrulegt
Náttúrlegt 	 náttúrulegt
náttúrulegt 	 Náttúrulegt
Fæðingarheimilinu 	 Fæðingarheimilið
Fæðingarheimilinu 	 Fæðingarheimilið
Ensk-Íslenskri 	 ensk-íslenskri
sprengivörpur 	 sprengjuvörpur
úthugsaðari 	 úthugsaðri
Föníska 	 Föníkía
Föníkía 	 Föníska
Föníska 	 Föníkía
Föníkía 	 Föníska
Pallteskja 	 Palteskja
CagliostroThe 	 Cagliostro
bíómmyndum 	 bíómyndum
Patrónímó 	 Patrónímós
demokrata 	 demókrata
demokrötum 	 demókrötum
Jósefusi 	 Jósefosi
Flavíus 	 Flavíos
Jósefus 	 Jósefos
Flavíus 	 Flavíos
Flavíus 	 Flavíos
Jósefus 	 Jósefos
appelsínusafanum 	 appelsínusafan
aðalega 	 aðallega
ofurnáttúrulegrar 	 yfirnáttúrulegrar
leikurun 	 leikurum
leikurun 	 leikurum
hústónlist 	 hústónlistar
hústónlistar 	 hústónlist
Jubaland 	 Júbaland
Puntland 	 Púntland
Somalía 	 Sómalía
Cabinda 	 Kabinda
Kurdistan 	 Kúrdistan
Kurdistan 	 Kúrdistan
Kurdistan 	 Kúrdistan
Kurdistan 	 Kúrdistan
نصرالدين 	 نصرالدین
þingeyrum 	 Þingeyrum
fjöritíu 	 fjörutíu
Endurreisnarinnar 	 endurreisnarinnar
Galileo 	 Galilei
Galilei 	 Galileo
Endurreisnarinnar 	 endurreisnarinnar
Galileo 	 Galilei
Galilei 	 Galileo
Rússneska 	 rússneska
rússneska 	 Rússneska
réttrúnaðarkirkjunum 	 rétttrúnaðarkirkjan
réttrúnaðarkirkjunum 	 réttrúnaðarkirkjunnar
andabæingum 	 Andabæingum
Sovjétríkjunum 	 Sovétríkjunum
ofan 	 ofan-
ofan- 	 ofan
cipangopaludina 	 Cipangopaludina
bellamya 	 Bellamya
viviparidae 	 Viviparidae
framkvæmda 	 framkvæmdar-
framkvæmdar- 	 framkvæmda
framkvæmdar- 	 framkvæmda
Indóevrópskra 	 indóevrópskra
Germanskra 	 germanskra
Norrænna 	 norrænna
Vesturnorrænna 	 vesturnorrænna
stúlkunar 	 stúlkunnar
eitthverjum 	 einhverjum
íslandssögunni 	 Íslandssögunni
Bandaríkjana 	 Bandaríkjanna
auðlindadeild 	 Auðlindadeild
hryðjuverkaárásunum 	 hryðjuverkaárásum
kynþáttamismunar 	 kynþáttamismunun
kynþáttamismunun 	 kynþáttamismunar
Keisaranum 	 keisaranum
Makkabeabókum 	 Makkabeabók
amtmnann 	 amtmann
uppp 	 upp
Postullega 	 Postulleg
postulleg 	 Postulleg
ullarlokbuxum 	 ullarbuxum
Fullvaxta 	 fullvaxta
fullvaxta 	 Fullvaxta
Fullvaxta 	 fullvaxta
fullvaxta 	 Fullvaxta
felmstursköst 	 felmtursköst
ástæðun 	 ástæðuna
felmstursköst 	 felmtursköst
ástæðun 	 ástæðuna
persónustyrkleikar 	 Persónustyrkleikar
hanbók 	 handbók
stofnunin 	 stofnuninnar
norðsnjáldri 	 norðursnjáldri
Nasreddins 	 Nasredin
Nasreddins 	 Nasreddine
Nasrudin 	 Nasredin
Nasrudin 	 Nasruddin
Nasredin 	 Nasreddins
Nasredin 	 Nasrudin
Nasredin 	 Nasreddine
Naseeruddin 	 Nasruddin
Nasruddin 	 Nasrudin
Nasruddin 	 Naseeruddin
Nastradhin 	 Nastradin
Nasreddine 	 Nasreddins
Nasreddine 	 Nasredin
Nastratin 	 Nastradin
Nusrettin 	 Nasrettin
Nasrettin 	 Nusrettin
Nostradin 	 Nastradin
Nastradin 	 Nastradhin
Nastradin 	 Nastratin
Nastradin 	 Nostradin
Airsoft 	 airsoft
airsoft 	 Airsoft
neytaði 	 neitaði
hæt 	 hætt
binst 	 bindst
Þjóðernisjafnaðarstefnuflokkur 	 Þjóðernisjafnaðarstefnuflokkurinn
stonfaði 	 stofnaði
Listamannalaun 	 Listamannalaunum
Launasjóði 	 launasjóði
Launasjóði 	 launasjóði
Launasjóði 	 launasjóði
Launasjóði 	 launasjóði
Launasjóði 	 launasjóði
Launasjóði 	 launasjóði
umboðsmaður 	 Umboðsmaður
umboðsmaður 	 Umboðsmaður
Oklahóma 	 Oklahoma
bandtrik 	 bandstrik
kornabreska 	 kornbreska
Keltek 	 Keltiek
Keltiek 	 Keltek
Kornabretlands 	 Kornbretalands
söguþráði 	 söguþræði
Lanarkshire 	 Lanrikshire
Lanrikshire 	 Lanarkshire
Lanrikshire 	 Lanarkshire
Lanarkshire 	 Lanrikshire
sytt 	 stytt
íbæta 	 bæta
bæta 	 íbæta
Northumbria 	 Northhumbria
Northhumbria 	 Northumbria
konungsríki 	 Konungsríkið
sjánlegri 	 sjáanlegri
einning 	 einnig
Rómerskt-kaþólsku 	 Rómversk-kaþólsku
Timburmenni 	 Timburmenn
sannleiksumsögninni 	 sannleiksumsögnin
sannleiksumsögninni 	 sannleiksumsögn
sannleiksumsögnin 	 sannleiksumsögninni
sannleiksumsögnin 	 sannleiksumsögn
þrú 	 þrjú
koltvísíring 	 koltvísýring
sýningarinna 	 sýningarinnar
síðrokks 	 síðrokk
síðrokk 	 síðrokks
indiependent 	 independent
rannsónir 	 rannsóknir
uppbyggs 	 uppbyggðs
Atómmassi 	 atómmassi
atómmassi 	 Atómmassi
meðaltalsatómmassi 	 meðalatómmassi
meðal-atómmassi 	 meðalatómmassi
kvikmyndym 	 kvikmyndum
sjókorta- 	 sjókort
sjókort 	 sjókorta-
fullvedi 	 fullveldi
hugmyndin 	 Hugmyndin
Demókratar 	 demókratar
Repúblikanar 	 repúblikanar
Κωνσταντινούπολη 	 Κωνσταντινούπολις
Stalín 	 Stalíns
Stalíns 	 Stalín
gljándi 	 gljáandi
yfileitt 	 yfirleitt
yfileitt 	 yfirleitt
yfileitt 	 yfirleitt
ákvarðanir 	 Ákvarðanir
ákvarðanir 	 Ákvarðanir
Stjörnuspáfræði 	 stjörnuspáfræði
stjörnuspeki 	 Stjörnuspeki
Leiðtogi 	 leiðtogi
leiðtogi 	 Leiðtogi
yfirleitt 	 Yfirleitt
böglaberum 	 bögglaberum
yfirleitt 	 Yfirleitt
böglaberum 	 bögglaberum
henntar 	 hentar
Tagalog 	 tagalog
Norðaustur 	 norðaustur
Budapest 	 Búdapest
Theresa 	 Theresia
Theresia 	 Teresa
katsuwonus 	 Katsuwonus
evrópusambandið 	 Evrópusambandið
evrópuráðsins 	 Evrópuráðsins
efnhagslegs 	 efnahagslegs
meðferðaer 	 meðferða
firstur 	 fyrstur
relations 	 relation
relation 	 relations
Sval 	 Svals
Svals 	 Sval
Svals 	 Sval
skrárir 	 skráir
erfðaauðlindum 	 erfðaauðlinda
reikingum 	 reykingum
Evrópskir 	 evrópskir
Alexenders 	 Alexanders
Florída 	 Flórída
Alþjóðasiglingareglur 	 alþjóðasiglingareglurnar
Skaftfellskur 	 skaftfellskur
Vestfirskur 	 vestfirskur
framburður 	 gð-framburður
framburður 	 hv-framburður
framburður 	 rl-framburður
ngl-framburður 	 gð-framburður
ngl-framburður 	 rl-framburður
gð-framburður 	 framburður
gð-framburður 	 ngl-framburður
hv-framburður 	 framburður
rl-framburður 	 framburður
rl-framburður 	 ngl-framburður
Englafossar 	 Englafoss
Englafoss 	 Englafossar
Concino 	 Concini
Concini 	 Concino
SigurSssyni 	 Sigurðssyni
neða 	 eða
neða 	 neðan
Vatnafjörður 	 Vatnsfjörður
svartmálmar 	 svartmálmi
valoppandi 	 valhoppandi
Ritskoðun 	 ritskoðun
ritskoðun 	 Ritskoðun
halluciantions 	 hallucinations
Appalasíafjöllum 	 Appalasíufjöllum
Virginia 	 Virginía
Virginia 	 Virginía
skattagrið 	 skattgriða
skattgriða 	 skattagrið
Forn-Grikkir 	 Forngrikkir
iðuhvolf 	 iðuhvolfið
iðuhvolfið 	 iðuhvolf
Ampers 	 Amperes
Ampère 	 Ampères
forth 	 fourth
leyðinni 	 leiðinni
náms- 	 náms
Menntavísindasviðs 	 Menntavísindasviði
annarar 	 annarrar
Aðalbandamenn 	 aðalbandamenn
aðalbandamenn 	 Aðalbandamenn
kaffigerðarvélum 	 kaffigerðarvélar
fjöbreytt 	 fjölbreytt
viskíbrennslna 	 viskíbrennslu
viskíbrennslu 	 viskíbrennslna
latínubækr 	 latínubækur
Kaliforníuháskóli 	 Kaliforníuháskóla
Kaliforníuháskóla 	 Kaliforníuháskóli
skráningartæki 	 skráningartækið
skráningartækið 	 skráningartæki
ödipusarduldin 	 Ödipusarduldin
Ilionskviða 	 Ilíonskviða
Vatnsleysuströndin 	 Vatnsleysuströnd
Vatnsleysuströndin 	 Vatnsleysuströnd
yfirráðun 	 yfirráð
siglingarleiðinni 	 siglingarleiðin
keltnenskur 	 keltneskri
keltnenskri 	 keltnenskur
keltnenskri 	 keltneskri
Samband 	 samband
Union 	 LUnion
LUnion 	 Union
samband 	 Samband
asíufíll 	 Asíufíll
asíufíll 	 Asíufíll
kvikasilfuroxíð 	 kvikasilfuroxíði
læknifræði 	 læknisfræði
Dave´s 	 Daves
samstarfsráðherra 	 Samstarfsráðherra
miðstöðvun 	 miðstöðvum
flúgvélaiðnaðarins 	 flugvélaiðnaðarins
Íhaldsmenn 	 íhaldsmenn
íhaldsmenn 	 Íhaldsmenn
landnámsmannana 	 landnámsmannanna
Hjör-leifs 	 Hjörleifs
samskifti 	 samskipti
Posessed 	 Possessed
Snjór 	 ‚Snjór
hvítur 	 hvítur‘
höfundsins 	 höfundarins
kvikasilfursmengunin 	 kvikasilfursmengun
kvikasilfursmagn 	 kvikasilfursmengun
Nordisk 	 Nordiskt
Kulturarvspædagogik 	 Kulturarvspedagogik
Grendel 	 Grendil
Grendels 	 Grendils
Útvíkuð 	 Útvíkkuð
Sambandssvæðið 	 Sambandssvæðinu
Sambandssvæðinu 	 Sambandssvæðið
Þorpslíf 	 Þorpslífið
hljómsveitina 	 hljósveitin
hljósveitin 	 hljómsveitina
hljósveitin 	 hljómsveitin
hljómsveitin 	 hljósveitin
Sovétríkinn 	 Sovétríkin
Demokrataflokkurinn 	 Demókrataflokkurinn
eignuðust 	 eignuðist
Frankfúrtskólans 	 Frankfurtskólans
Frankfúrtskólans 	 Frankfurtskólans
Shaanxi 	 Shanxi
Shanxi 	 Shaanxi
ægisvald 	 ægivald
Stærðfræði 	 stærðfræði
Stærðfræði 	 stærðfræði
Stærðfræðikeppnina 	 stærðfræðikeppnina
Stærðfræði 	 stærðfræði
Stærðfræði 	 stærðfræði
sikileyjarvörn 	 Sikileyjarvörn
afbrigiðið 	 afbrigðið
kóngapeðsbyrjun 	 kóngspeðsbyrjun
Íslensk 	 íslensk
tján 	 tjákn
tján 	 tjá
sebtett 	 sextett
sebtett 	 septett
nontett 	 nonett
legst 	 leggst
hestsisn 	 hestsins
Gentrification 	 gentrification
einier 	 einer
Walfgang 	 Walfang
Eskimóasfjölskyldu 	 Eskimóafjölskyldu
Jouvenels 	 Jouvenel
Gyðingaættum 	 gyðingaættum
Jouvenel 	 Jouvenels
Aríanna 	 aríanna
Rómafólki 	 rómafólki
Ashikaga-sjóguna-stjórnina 	 Ashikaga-sjógunastjórnina
Messer 	 Messers
Elbe 	 Elben
Elben 	 Elbe
elfur 	 elfr
Leakeys 	 Leakey
Leakey 	 Leakeys
Snjór 	 ‚Snjór
hvítur 	 hvítur‘
fullyrðignunni 	 fullyrðingunni
hvítur 	 hvítur‘
hasemíta 	 Hasemíta
Bergstaðastræti 	 Bergstaðstræti
Bergstaðstræti 	 Bergstaðastræti
Motorhead 	 Motörhead
tegundi 	 tegundin
aðalkvennhlutverkið 	 aðalkvennhlutverkinu
þrangar 	 þröngar
-torg 	 torg
torg 	 -torg
vanalga 	 vanalega
forn-persneska 	 fornpersneska
geklofa 	 geðklofa
biblíutextarnir 	 Biblíutextarnir
frumnnorrænu 	 frumnorrænu
tónlistin 	 hústónlistin
tónlistin 	 hústónlistin
tónlistin 	 hústónlistin
tónlistin 	 hústónlistin
eldfjallafræðinga 	 eldfjallafræði
eldfjallafræðinga 	 eldfjallafræði
alþjóðasamskipti 	 alþjóðasamskiptum
Bandarískt 	 bandarískt
alþjóðasamskiptum 	 alþjóðasamskipti
Bill 	 Bills
Clintons 	 Clinton
Aleuts-eyjar 	 Aleut-eyjar
haskóli 	 háskóli
Réttsælis 	 réttsælis
Karatsjaj-Tsjerkessíja 	 Karatsjaj-Tsjerkassíu
skjalasniða 	 skjalasnið
Fionn 	 Finn
Fionn 	 Finn
Cumhail 	 Cumhaill
Cumhail 	 Cumail
Finn 	 Fionn
Cumail 	 Cumhaill
Finn 	 Fionn
Fionn 	 Finn
Fionn 	 Finn
Cumhail 	 Cumhaill
Cumhail 	 Cumail
Finn 	 Fionn
Cumail 	 Cumhaill
Finn 	 Fionn
Vallée 	 Valle
Valle 	 Vallée
Þjóðarflokkurinn 	 þjóðarflokkurinn
Þjóðarflokkurinn 	 Þjóðarflokkur
nationella 	 Nationella
Nationella 	 nationella
Nanjin 	 Nanjing
Nanking 	 Nanjing
Nanjin 	 Nanjing
Nanjing 	 Nanking
Nanjing 	 Nanjin
Nasistanna 	 nasistanna
svæðissamtök 	 Svæðissamtök
Miðjarðarhafsloftslagi 	 miðjarðarhafsloftslagi
lífetanól 	 lífmetanól
lífmetanól 	 lífetanól
Ishtar-hliðið 	 Istarhliðið
aleutíska 	 aleútíska
heimstyrjalarinnar 	 heimsstyrjaldarinnar
yngismans 	 yngismanns
Setningin 	 setningin
þýskalandi 	 Þýskalandi
setninginn 	 setningin
Östersund 	 Östersunds
läns 	 län
Jamtaléni 	 Jamtaléns
Jamtaléni 	 Jamtaléns
län 	 läns
Östersunds 	 Östersund
Östersunds 	 Östersund
Östersund 	 Östersunds
´´Samstarfslausum 	 samstarfslausum
Stærðfræðileg 	 stærðfræðilegan
Stærðfræðileg 	 stærðfræðilegra
stærðfræðilegan 	 Stærðfræðileg
stærðfræðilegra 	 Stærðfræðileg
meiðlsa 	 meiðsla
álfræðilega 	 sálfræðilega
felmstursröskunum 	 felmtursröskunum
felmstursröskuninni 	 felmtursröskuninni
álfræðilega 	 sálfræðilega
felmstursröskunum 	 felmtursröskunum
felmstursröskuninni 	 felmtursröskuninni
blokinni 	 blokkinni
blokkinni 	 blokinni
blokinni 	 blokkinni
blokkinni 	 blokinni
verkefni 	 Verkefni
verkefni 	 Verkefni
gjaldmiðilsisn 	 gjaldmiðilsins
hundurinn 	 Hundurinn
Hundurinn 	 hundurinn
neanderdalsmennina 	 neanderdalsmenn
neanderdalsmenn 	 neanderdalsmennina
aukaafurði 	 aukaafurð
fjölvínýlklóríð 	 fjölvínýlklóríðs
klórdíoxíð 	 klórdíoxíðs
aukaafurði 	 aukaafurð
fjölvínýlklóríð 	 fjölvínýlklóríðs
klórdíoxíð 	 klórdíoxíðs
illskyljanleg 	 illskiljanleg
aðskilnaðarstefnunar 	 aðskilnaðarstefnunnar
aðskilnaðarstefnunar 	 aðskilnaðarstefnunnar
Vestrænni 	 vestrænni
vajrayana 	 vajrayāna
vajrayāna 	 vajrayana
mantrayana 	 tantrayana
tantrayana 	 mantrayana
animēshon 	 animēshon-
Fransk-Kanadíska 	 fransk-kanadíska
Stökkbreyttu 	 stökkbreyttu
Stökkbreyttu 	 stökkbreytt
Kyrrhafið 	 Kyrrahafið
Georges 	 George
Georges 	 George
muehlenbergii 	 muhlenbergii
muhlenbergii 	 muehlenbergii
örgjörfa 	 örgjörva
örgjörfa 	 örgjörva
framandalegum 	 framandlegum
arkítektum 	 arkitektum
arkítekta 	 arkitekta
byggingarverkfræðinga 	 byggingaverkfræðinga
hip 	 hipp
jugle 	 jungle
Pekin 	 Peking
Peking 	 Pekin
Bósníumenn 	 Bosníumenn
liturinn 	 Liturinn
tilfiningum 	 tilfinningum
Einkeypi 	 einkeypi
einkeypi 	 Einkeypi
kennslutæknir 	 kennslutækni
Tajikistan 	 Tadsikistan
Afghanistan 	 Afganistan
Moody’s 	 Moodys
Standard’s 	 Standards
Poor’s 	 Poors
fjöldanetspunaleikur 	 fjölnotendanetspunaleikur
physalis 	 Physalis
Physalis 	 physalis
fylkjasambandið 	 Fylkjasambandið
Rojavaya 	 Rojava
Fylkjasambandið 	 fylkjasambandið
Fylkjasambandið 	 fylkjasamband
Rojava 	 Rojavaya
fylkjasamband 	 Fylkjasambandið
Tilbúin 	 Tilbúið
Svinssneska 	 Svissneska
Svizzera 	 Svizra
Svizra 	 Svizzera
örgjörva 	 örgjörvan
Stephensons 	 Stephenson
Stephenson 	 Stephensons
Stephenson 	 Stephensons
mafjármálastarfssemi 	 fjármálastarfssemi
bankanaskattaskjól 	 bankannaskattaskjól
Aðgerðir 	 aðgerðir
aðgerðir 	 Aðgerðir
heitttrúaður 	 heittrúaður
Shaanxi 	 Shanxi
Shanxi 	 Shaanxi
Language 	 language
annann 	 annan
hanns 	 hann
hanns 	 hann
hann 	 hanns
hann 	 hanns
Kynferðisleg 	 kynferðisleg
kynferðisleg 	 Kynferðisleg
Phylogenetic 	 phylogenetic
Alkahólismi 	 Alkóhólismi
assembly 	 Assembly
hverastrýta 	 hverastrýtum
hverastrýtum 	 hverastrýta
Harúns 	 Harún
Harún 	 Harúns
Franska 	 franska
Vestur-Afríka 	 Vestur-Afríku
franska 	 Franska
Vestur-Afríku 	 Vestur-Afríka
Franska 	 franska
Franska 	 franska
Vestur-Afríka 	 Vestur-Afríku
franska 	 Franska
Vestur-Afríku 	 Vestur-Afríka
Franska 	 franska
lceland 	 Iceland
lcelandic 	 Icelandic
lcelandic 	 Icelandic
Icelandic 	 Iceland
miðjann 	 miðjan
Dubstep 	 dubstep
Kust 	 Kunst
slesísk 	 slésísk
slesíska 	 slésíska
Freising 	 Freisinger
Freising 	 Freisinger
einkenntist 	 einkenndist
skllningi 	 skilningi
deyji 	 deyi
deyji 	 deyi
deyji 	 deyi
deyji 	 deyi
útbreyðslu 	 útbreiðslu
genisins 	 gensins
hetitinu 	 heitinu
hemoglobin 	 haemoglobin
haemoglobin 	 hemoglobin
hemglóbín 	 hemóglóbíni
hemóglóbíni 	 hemglóbín
National 	 national
pera 	 pra
pira 	 pra
pra 	 pera
pra 	 pira
pomelo 	 pomello
pomelo 	 pommelo
pomello 	 pomelo
pomello 	 pommelo
pummelo 	 pommelo
pommelo 	 pommeló
pommelo 	 pomelo
pommelo 	 pomello
pommelo 	 pummelo
shaddick 	 shaddock
shaddock 	 shaddick
Lárusdótttir 	 Lárusdóttir
staðreydnir 	 staðreyndir
adenósínþrífosfat 	 gúanósínþrífosfat
gúanósínþrífosfat 	 adenósínþrífosfat
hring-adenósín 	 hring-gúanósín
hring-gúanósín 	 hring-adenósín
bakkalárhráðu 	 bakkalárgráðu
Afghanistan 	 Afganistan
Turkmenistan 	 Túrkmenistan
Evrópuhluti 	 Evrópuhluta
Kaliforníuháskóli 	 Kaliforníuháskóla
SKólinn 	 Skólinn
Kaliforníuháskóla 	 Kaliforníuháskóli
Þjóðskjalaefnni 	 Þjóðskjalasafni
styjðja 	 styðja
sérsrhvers 	 sérhvers
LóþarI 	 Lóþar
kendi 	 kenndi
»kunni 	 kunni
»kunni 	 kunni
lægja« 	 lægja
Mótsögn 	 mótsögn
lággildispunktur 	 hágildispunktur
hágildispunktur 	 lággildispunktur
Bur 	 Buer
kumt 	 kummt
kínahverfi 	 kínahverfinu
kínahverfinu 	 kínahverfi
furugana 	 furigana
Kolmogorov 	 Kolmogorovs
frumsemdur 	 frumsemdum
frumsemdur 	 frumsendur
frumsemdur 	 frumsendur
frumsemdur 	 frumsendur
frumsemdur 	 frumsemdum
frumsemdur 	 frumsendur
frumsemdur 	 frumsendur
frumsemdur 	 frumsendur
frumsemdur 	 frumsemdum
frumsemdur 	 frumsendur
frumsemdur 	 frumsendur
frumsemdur 	 frumsendur
Kolmogorovs 	 Kolmogorov
Einstaklingur 	 einstaklingur
skýringarstíl 	 skýringastíl
einstaklingur 	 Einstaklingur
skýringastíl 	 skýringarstíl
sköttunu 	 sköttunum
Joseph-Desiré 	 Joseph-Désiré
fjöllyfjameðferð 	 lyfjameðferð
fjöllyfjameðferð 	 lyfjameðferð
lyfjameðferð 	 fjöllyfjameðferð
lyfjameðferð 	 fjöllyfjameðferð
byggingareining 	 aðalbyggingareining
han 	 hans
han 	 hann
Kjarnaorkuvopn 	 Kjarnorkuvopn
klofningarvopn 	 klofnunarvopn
kjarnaverkanna 	 kjarnaverkana
elsa 	 elsta
MArokkó 	 Marokkó
norður-Íraks 	 Norður-Íraks
Himalayafjalla 	 Himalajafjalla
MArokkó 	 Marokkó
norður-Íraks 	 Norður-Íraks
Himalayafjalla 	 Himalajafjalla
Trójustríðinu 	 Trójustríðið
Trójustríðið 	 Trójustríðinu
Angouleme 	 Angoulême
Dæmið 	 Dæmi
Brismylasi 	 brismylasi
stofnfrumur 	 stofnfrumum
stofnfrumum 	 stofnfrumur
stofnfrumur 	 Stofnfrumur
stofnfrumur 	 Stofnfrumur
stofnfrumur 	 Stofnfrumur
Alpasreynis 	 Alpareynis
Germani 	 Germana
Germanía 	 Germana
Germanna 	 Germanía
Germanna 	 Germana
Agricola 	 Agricolae
Agricolae 	 Agricola
Agricolae 	 Agricola
Agricolae 	 Agricola
Agricola 	 Agricolae
Agricola 	 Agricolae
Rokksins 	 rokksins
Blússins 	 blússins
Rokkhljómsveitirnar 	 rokkhljómsveitirnar
You 	 Your
Prince 	 Price
Price 	 Prince
Your 	 You
Kleyfarvatn 	 Kleifarvatn
Lagaskóla 	 Lagaskóli
Fullkomna 	 fullkomna
Californíu 	 Kaliforníu
Skipanaviðmót 	 Skipanalínuviðmót
Heike 	 ‘Heike
‘Heike 	 Heike
órafmögnuð 	 rafmögnuð
rafmögnuð 	 órafmögnuð
ættgöfga 	 ættgöfgi
Hlíðadrapi 	 hlíðadrapi
picaro 	 picar
picaro 	 picar
Disorder 	 Disorders
Disorders 	 Disorder
Disorders 	 Disorder
Disorders 	 Disorder
Disorder 	 Disorders
Disorder 	 Disorders
Мі́нскі 	 Мінскі
Радыётэхні́чны 	 Радыетэхнічны
Кале́дж 	 Каледж
колледж 	 Колледж
Колледж 	 колледж
Мінскі 	 Мі́нскі
Радыетэхнічны 	 Радыётэхні́чны
Каледж 	 Кале́дж
bassie 	 bassi
bass 	 bassi
mostrarskeggs 	 Mostrarskeggs
heimsstyrjöldinnialveg 	 heimsstyrjöldinni
eðlisfræðingur 	 heimsfræðingur
sálfræðingur 	 málmfræðingur
málmfræðingur 	 sálfræðingur
eðlisfræðingur 	 heimsfræðingur
heimsfræðingur 	 eðlisfræðingur
Magnúsdóthr 	 Magnúsdóttir
Mekong 	 Maekong
tíbetönsku 	 tíbetsku
Maekong 	 Mekong
Instrunction 	 Instruction
innihelduer 	 inniheldur
innihelduer 	 inniheldur
innihelduer 	 inniheldur
innihelduer 	 inniheldur
Víkinga-þungarokksins 	 víkingaþungarokksins
Filippeyska 	 Filippeyskum
Sanskrít 	 sanskrít
sérhljóðasá 	 sérhljóða
sérhljóðasá 	 sérhljóða
Sanskrít 	 sanskrít
Filippeyskum 	 Filippeyska
refsingar 	 Refsingar
refsingar 	 Refsingar
hagstjón 	 hagstjórn
Hollenska 	 Hollensku
þjóðaframleiðsla 	 þjóðarframleiðsla
sparnaðahlutfall 	 sparnaðarhlutfall
Íslenskir 	 Íslenzkir
Þrísteini 	 Þrístein
Þrístein 	 Þrísteini
